Rank,Released,Movies,worldwide box office $,domestic box office $,international box office $
1,2009,Avatar,2923706026,785221649,2138484377
2,2019,Avengers: Endgame,2794731755,858373000,1936358755
3,2022,Avatar: The Way of Water,2318552513,683875614,1634676899
4,2018,Avengers: Infinity War,2048359754,678815482,1369544272
5,2021,Spider-Man: No Way Home,1910048245,814115070,1095933175
6,2015,Jurassic World,1669963641,652306625,1017657016
7,2012,The Avengers,1515100211,623357910,891742301
8,2015,Furious 7,1514553486,353007020,1161546466
9,2022,Top Gun: Maverick,1481369482,718732821,762636661
10,2015,Avengers: Age of Ultron,1395316979,459005868,936311111
11,2018,Black Panther,1336494320,700059566,636434754
12,2018,Jurassic World: Fallen Kingdom,1308323302,417719760,890603542
13,2017,The Fate of the Furious,1236703796,225764765,1010939031
14,2013,Iron Man 3,1215392272,408992272,806400000
15,2016,Captain America: Civil War,1151899586,408084349,743815237
16,2018,Aquaman,1143758700,335061807,808696893
17,2019,Spider-Man: Far From Home,1132107522,390532085,741575437
18,2019,Captain Marvel,1129576094,426829839,702746255
19,2011,Transformers: Dark of the Moon,1123794079,352390543,771403536
20,2012,Skyfall,1110526981,304360277,806166704
21,2014,Transformers: Age of Extinction,1104054072,245439076,858614996
22,2012,The Dark Knight Rises,1082228107,448139099,634089008
23,2008,The Dark Knight,1006234167,534987076,471247091
24,2022,Jurassic World: Dominion,1003775632,376851080,626924552
25,2022,Doctor Strange in the Multiverse of Madness,952224986,411331607,540893379
26,2023,The Super Mario Bros. Movie,912996157,450015825,462980332
27,2021,Chang jin hu,909596236,333214,909263022
28,2015,Spectre,879077344,200074175,679003169
29,2017,Spider-Man: Homecoming,878271291,334201140,544070151
30,2016,Batman v Superman: Dawn of Justice,872395091,330360194,542034897
31,2017,Guardians of the Galaxy Vol 2,869087963,389813101,479274862
32,2018,Venom,856081053,213511408,642569645
33,2022,Black Panther: Wakanda Forever,854041058,453829060,400211998
34,2017,Thor: Ragnarok,850482778,315058289,535424489
35,2009,Transformers: Revenge of the Fallen,836519699,402111870,434407829
36,2017,Zhan Lang 2,835474171,2721100,832753071
37,2017,Wonder Woman,817691766,412563408,405128358
38,2013,Fast and Furious 6,789300444,238679850,550620594
39,2018,Mission: Impossible—Fallout,787176729,220159104,567017625
40,2018,Deadpool 2,786362370,324591735,461770635
41,2016,Deadpool,781947691,363070709,418876982
42,2014,Guardians of the Galaxy,770882395,333714112,437168283
43,2022,The Batman,766039263,369345583,396693680
44,2022,Thor: Love and Thunder,760928081,343256830,417671251
45,2019,Fast & Furious Presents: Hobbs & Shaw,760732926,173956935,586775991
46,2021,No Time to Die,759959662,160891007,599068655
47,2009,2012,757677748,166112167,591565581
48,2014,X-Men: Days of Future Past,747862775,233921534,513941241
49,2016,Suicide Squad,745744980,325100054,420644926
50,2003,The Matrix Reloaded,738576929,281553689,457023240
51,2021,F9: The Fast Saga,720752238,173005945,547746293
52,2014,Captain America: The Winter Soldier,714401889,259746958,454654931
53,2014,The Amazing Spider-Man 2,708996336,202853933,506142403
54,2007,Transformers,708272592,319246193,389026399
55,2019,Liu Lang Di Qiu,701801455,5875487,695925968
56,2021,Tang Ren Jie Tan An 3,699072066,0,699072066
57,2011,Mission: Impossible—Ghost Protocol,694713230,209397903,485315327
58,2015,Mission: Impossible—Rogue Nation,688858992,195042377,493816615
59,2016,Doctor Strange,676343174,232641920,443701254
60,2013,Man of Steel,667999518,291045518,376954000
61,2017,Justice League,655945209,229024295,426920914
62,2013,Thor: The Dark World,644602516,206362140,438240376
63,2011,Fast Five,630163454,210031325,420132129
64,2008,Hancock,624234272,227946274,396287998
65,2018,Ant-Man and the Wasp,623144660,216648740,406495920
66,2010,Iron Man 2,621156389,312433331,308723058
67,1997,The Lost World: Jurassic Park,618638999,229086679,389552320
68,2017,Logan,614202315,226277068,387925247
69,2005,War of the Worlds,606836535,234280354,372556181
70,2023,Liú Làng Dì Qiú 2 (流浪地球2),604292296,5023132,599269164
71,2022,Chang Jin Hu Zhi Shui Men Qiao (长津湖之水门桥)…,602986104,0,602986104
72,2017,Transformers: The Last Knight,602893340,130168683,472724657
73,2006,Casino Royale,594420216,167365000,427055216
74,2008,Quantum of Solace,591692078,169368427,422323651
75,2000,Mission: Impossible 2,549588516,215409889,334178627
76,2018,Tang Ren Jie Tan An 2,544068574,1983984,542084590
77,2018,Hong Hai Xing Dong,543391535,1543547,541847988
78,2016,X-Men: Apocalypse,542537546,155442489,387095057
79,2011,Sherlock Holmes: A Game of Shadows,535663443,186848418,348815025
80,2013,World War Z,531861650,202706711,329154939
81,2014,Godzilla,529076069,200676069,328400000
82,2018,The Meg,527267828,145443742,381824086
83,2015,Ant-Man,518858449,180202163,338656286
84,1991,Terminator 2: Judgment Day,515376182,203464105,311912077
85,2017,Dunkirk,512390011,190068280,322321731
86,2021,Venom: Let There be Carnage,501546922,213550366,287996556
87,1996,Twister,495700000,241688385,254011615
88,2010,Clash of the Titans,493214888,163214888,330000000
89,2017,War for the Planet of the Apes,489592267,146880162,342712105
90,2005,Mr. and Mrs. Smith,486124090,186336279,299787811
91,2004,Troy,483152040,133298577,349853463
92,2020,Ba bai,472648086,0,472648086
93,2021,Godzilla vs. Kong,468043852,100916094,367127758
94,1999,The Matrix,465974198,173993387,291980811
95,2023,Ant-Man and the Wasp: Quantumania,465312442,212960787,252351655
96,2006,X-Men: The Last Stand,459260946,234362462,224898484
97,1996,Mission: Impossible,457697994,180981886,276716108
98,2014,Lucy,457507776,126573960,330933816
99,2003,The Last Samurai,456810575,111110575,345700000
100,2007,300,454161935,210614939,243546996
101,2000,Gladiator,452282115,187683805,264598310
102,2011,Thor,449326618,181030624,268295994
103,2001,Pearl Harbor,449239853,198539855,250699998
104,2002,Men in Black 2,441767803,190418803,251349000
105,2016,Warcraft,438899824,47365290,391534534
106,2003,Terminator 3: Rise of the Machines,433058296,150358296,282700000
107,2021,Shang-Chi and the Legend of the Ten Rings,432224634,224543292,207681342
108,2015,Terminator: Genisys,432150894,89760956,342389938
109,2002,Die Another Day,431942139,160942139,271000000
110,2018,Rampage,427947217,101028233,326918984
111,2003,The Matrix Revolutions,427300260,139270910,288029350
112,2020,Bad Boys For Life,424471663,204417855,220053808
113,2013,The Wolverine,416456852,132556852,283900000
114,2016,Jason Bourne,416168316,162192920,253975396
115,1989,Batman,411348924,251188924,160160000
116,2013,Pacific Rim,411002906,101802906,309200000
117,2017,Kingsman: The Golden Circle,408803696,100234838,308568858
118,2003,X-Men 2,406348630,214949694,191398936
119,2015,Kingsman: The Secret Service,404561724,128261724,276300000
120,2019,Alita: Battle Angel,401900040,85838210,316061830
121,2021,Eternals,401731759,164870264,236861495
122,2006,Mission: Impossible III,399387745,133501348,265886397
123,2021,Dune,391774790,108327830,283446960
124,2022,Black Adam,391261706,168152111,223109595
125,2016,Independence Day: Resurgence,384169424,103144286,281025138
126,2019,Godzilla: King of the Monsters,383299914,110500138,272799776
127,2007,Live Free or Die Hard,382288147,134529403,247758744
128,2021,Black Widow,379751131,183651655,196099476
129,1998,Godzilla,376000000,136314294,239685706
130,2013,G.I. Joe: Retaliation,375740705,122523060,253217645
131,2009,X-Men Origins: Wolverine,374825760,179883157,194942603
132,2011,Captain America: The First Avenger,370569776,176654505,193915271
133,2014,Edge of Tomorrow,367028980,100206256,266822724
134,1995,Die Hard: With a Vengeance,366101666,100012499,266089167
135,2001,Jurassic Park III,365900000,181166115,184733885
136,2015,Mad Max: Fury Road,365769378,153636354,212133024
137,2009,Terminator Salvation,365491792,125322469,240169323
138,1994,True Lies,365300000,146282411,219017589
139,2019,Shazam!,363563907,140371656,223192251
140,2023,John Wick: Chapter 4,363518350,171155296,192363054
141,1999,The World is Not Enough,361730660,126930660,234800000
142,2020,Tenet,360240189,58504105,301736084
143,2009,Fast & Furious,359347833,155064265,204283568
144,2005,Batman Begins,358858124,205343774,153514350
145,2002,Minority Report,358824714,132024714,226800000
146,1986,Top Gun,357469522,180470489,176999033
147,1995,Goldeneye,356429933,106429941,249999992
148,2011,X-Men: First Class,355408305,146408305,209000000
149,2010,The Karate Kid,351774938,176591618,175183320
150,2004,"I, Robot",348629585,144801023,203828562
151,2014,The Maze Runner,348319861,102427862,245891999
152,2001,Rush Hour 2,347425832,226164286,121261546
153,2017,xXx: Return of Xander Cage,345033359,44898413,300134946
154,2008,Wanted,342416460,134508551,207907909
155,1997,Tomorrow Never Dies,339504276,125304276,214200000
156,1995,Batman Forever,336529144,184031112,152498032
157,2010,Prince of Persia: Sands of Time,336359676,90759676,245600000
158,1996,The Rock,336069511,134069511,202000000
159,2016,The Great Wall,334486852,45157105,289329747
160,2005,Fantastic Four,333132750,154696080,178436670
161,2014,300: Rise of an Empire,330780051,106580051,224200000
162,2015,Taken 3,327656424,89256424,238400000
163,2019,John Wick: Chapter 3 — Parabellum,327203701,171016727,156186974
164,2021,Free Guy,323473792,121626598,201847194
165,2010,Robin Hood,322459006,105487148,216971858
166,1992,Lethal Weapon 3,319700000,144731527,174968473
167,2009,Inglourious Basterds,316802281,120774594,196027687
168,1997,Air Force One,315268353,172956409,142311944
169,2012,Battleship,313477717,65233400,248244317
170,2012,The Expendables 2,311979256,85028192,226951064
171,2015,Maze Runner: The Scorch Trials,310566162,81697192,228868970
172,1996,Ransom,308700000,136492681,172207319
173,2016,Dangal,305149461,12391761,292757700
174,2018,Skyscraper,304858121,68420120,236438001
175,2013,A Good Day to Die Hard,304249198,67349198,236900000
176,2009,G.I. Joe: The Rise of Cobra,302469017,150201498,152267519
177,1985,Rambo: First Blood Part II,300400000,150415432,149984568
178,2004,Van Helsing,300150546,120150546,180000000
179,2018,Ocean’s 8,297718711,140218711,157500000
180,2000,X-Men,296872367,157299717,139572650
181,2015,The Divergent Series: Insurgent,295075882,130179072,164896810
182,2018,Pacific Rim: Uprising,290930148,59874525,231055623
183,2007,Fantastic Four: Rise of the Silver Surfer,289480691,131921738,157558953
184,2013,Elysium,286192091,93050117,193141974
185,1998,Lethal Weapon 4,285400000,130444603,154955397
186,1994,Speed,283200000,121248145,161951855
187,2018,Tomb Raider,273477501,58250803,215226698
188,2003,Bad Boys II,273271982,138540870,134731112
189,2010,The Expendables,268268174,103068524,165199650
190,2002,xXx,267200000,141930000,125270000
191,1992,Batman Returns,266824291,162833635,103990656
192,2018,Maze Runner: The Death Cure,265878536,58032443,207846093
193,1995,Waterworld,264246220,88246220,176000000
194,1997,The Fifth Element,263892820,63570862,200321958
195,2011,Real Steel,263880341,85463309,178417032
196,2017,Baahubali 2: The Conclusion,263502914,18985794,244517120
197,1990,Total Recall,261399830,119394839,142004991
198,2000,Charlie's Angels,259736090,125305545,134430545
199,2010,Knight and Day,258751370,76423035,182328335
200,2007,Rush Hour 3,256585882,140125968,116459914
201,2017,Gong fu yu jia,256004127,362657,255641470
202,1993,Cliffhanger,255000000,84049211,170950789
203,2013,After Earth,251499665,60522097,190977568
204,1998,Enemy of the State,250649836,111549836,139100000
205,2019,Terminator: Dark Fate,250367666,62253077,188114589
206,2017,Xi You Fu Yao Pian,248805149,880346,247924803
207,2019,Dark Phoenix,246356895,65845974,180510921
208,1998,Rush Hour,245300000,141186864,104113136
209,2003,Hulk,245031679,132177234,112854445
210,2014,RoboCop,242981799,58607007,184374792
211,1997,Face/Off,241199984,112276146,128923838
212,2016,Assassin’s Creed,240759682,54647948,186111734
213,1990,Die Hard 2,239813888,117323878,122490010
214,1997,Batman & Robin,238317814,107325195,130992619
215,2003,2 Fast 2 Furious,236410607,127120058,109290549
216,1996,Eraser,234400000,101295562,133104438
217,2000,Gone in 60 Seconds,232643008,101643008,131000000
218,2007,Ghost Rider,229545589,115802596,113742993
219,2011,The Green Hornet,229155503,98780042,130375461
220,1989,Lethal Weapon 2,227300000,147253986,80046014
221,2003,Charlie's Angels: Full Throttle,227163273,100814328,126348945
222,1997,Con Air,224117573,101117573,123000000
223,2014,Non-Stop,222383055,91742160,130640895
224,2005,Constantine,221593554,75976178,145617376
225,2014,Dracula Untold,220241723,55991880,164249843
226,2011,Green Lantern,219535492,116601172,102934320
227,2005,Kingdom of Heaven,218674938,47398413,171276525
228,2004,Collateral,217602967,100170152,117432815
229,2013,Hansel & Gretel: Witch Hunters,214949716,55703475,159246241
230,2000,"Crouching Tiger, Hidden Dragon",213964810,128517946,85446864
231,2011,Battle: Los Angeles,213463976,83552429,129911547
232,1999,End of Days,212026975,66889043,145137932
233,2012,Total Recall,211856088,58877969,152978119
234,2011,Immortals,211562435,83504017,128058418
235,2021,Nou fo,211227284,385305,210841979
236,1979,Moonraker,210300000,70300000,140000000
237,2014,The Expendables 3,209461378,39322544,170138834
238,1994,Clear and Present Danger,207500000,122012656,85487344
239,2003,S.W.A.T.,207154748,116877597,90277151
240,2001,The Fast and the Furious,206458372,144512310,61946062
241,2020,Chai Dan Zhuan Jia Er,203481407,0,203481407
242,2020,Birds of Prey (And the Fantabulous Emancipation…,201005552,84158461,116847091
243,1979,Rocky 2,200182160,85182160,115000000
244,2021,Chinese Doctors,196863514,0,196863514
245,2010,Red,196439693,90380162,106059531
246,2021,Gekijouban Jujutsu Kaisen 0,196290952,33919605,162371347
247,1981,For Your Eyes Only,195300000,54800000,140500000
248,2014,Need for Speed,194169619,43568507,150601112
249,2016,Xi You Ji zhi Sun Wu Kong San Da Bai Gu Jing,194058503,709982,193348521
250,2002,The Sum of All Fears,193500000,118471320,75028680
251,2014,The Equalizer,192903624,101530738,91372886
252,2019,Yip Man 4,192617891,3956031,188661860
253,1987,The Living Daylights,191199996,51185000,140014996
254,2018,The Equalizer 2,190376181,102084362,88291819
255,1998,The X Files: Fight the Future,189176423,83898313,105278110
256,1988,Rambo III,188715611,53715611,135000000
257,1983,Octopussy,187500000,67900000,119600000
258,2009,Watchmen,186976250,107509799,79466451
259,2019,The White Storm 2: Drug Lords,185427900,0,185427900
260,1977,The Spy Who Loved Me,185400000,46800000,138600000
261,2017,The Hitman’s Bodyguard,183415183,75468583,107946600
262,1986,Aliens,183291893,85160248,98131645
263,2003,Daredevil,182782518,102543518,80239000
264,2015,Jupiter Ascending,181982519,47482519,134500000
265,1992,Patriot Games,178100000,83287363,94812637
266,1999,Double Jeopardy,177835231,116735231,61100000
267,2002,Jet Li's Hero,177535958,53652140,123883818
268,2010,The A-Team,177241171,77222099,100019072
269,2003,Kill Bill: Volume 1,176469428,70098138,106371290
270,2011,Cowboys and Aliens,176038324,100368560,75669764
271,2016,Operation Mekong,174279252,800012,173479240
272,2004,AVP: Alien Vs. Predator,172543519,80281096,92262423
273,2016,The Divergent Series: Allegiant,172022517,66184051,105838466
274,2006,Blood Diamond,171377916,57377916,114000000
275,2008,Cloverfield,171302226,80048433,91253793
276,2017,John Wick: Chapter Two,171139626,92029184,79110442
277,2012,Looper,170466405,66486205,103980200
278,1994,The Specialist,170362581,57362581,113000000
279,2012,Shi Er Sheng Xiao,169994606,0,169994606
280,1997,The Saint,169400000,61363304,108036696
281,2017,Ghost in the Shell,167910690,40563557,127347133
282,2015,The Fantastic Four,167849187,56117548,111731639
283,2004,Alexander,167297191,34297191,133000000
284,2021,The Suicide Squad,167097737,55817425,111280312
285,2020,Jin gang chuan,167007608,0,167007608
286,2019,Gemini Man,166598362,48546770,118051592
287,2020,Wonder Woman 1984,166360232,46801036,119559196
288,2002,The Scorpion King,165890634,90580000,75310634
289,2010,Unstoppable,165720921,81562942,84157979
290,2016,The Huntsman: Winter’s War,165149302,48003015,117146287
291,2006,Miami Vice,164920076,63478838,101441238
292,2007,No Country for Old Men,164035753,74273505,89762248
293,2005,The Island,163018913,35818913,127200000
294,2022,Morbius,162759437,73865530,88893907
295,1990,Dick Tracy,162738726,103738726,59000000
296,2022,One Piece Film: Red,162487422,12768073,149719349
297,1973,Live and Let Die,161800000,35400000,126400000
298,1999,Payback,161626121,81526121,80100000
299,1997,Alien: Resurrection,160700000,47795018,112904982
300,2008,Hellboy II: The Golden Army,160388063,75986503,84401560
301,2012,Underworld: Awakening,160379930,62321039,98058891
302,1983,Never Say Never Again,160000000,55500000,104500000
303,2016,Jack Reacher: Never Go Back,159946489,58697076,101249413
304,2021,Ci Sha Xiao Shuo Jia,159944397,0,159944397
305,2022,K.G.F: Chapter 2,159887058,6604562,153282496
306,2001,Black Hawk Down,159691085,108638745,51052340
307,2018,The Predator,159487563,51024708,108462855
308,1995,Crimson Tide,159387195,91387195,68000000
309,2021,The Matrix Resurrections,159197755,40463197,118734558
310,1993,Demolition Man,159055768,58055768,101000000
311,1996,Daylight,158908290,32908290,126000000
312,2010,The Book of Eli,158750817,94835059,63915758
313,1992,Alien 3,158500000,54927174,103572826
314,2006,The Fast and the Furious: Tokyo Drift,157794205,62615510,95178695
315,1990,Days of Thunder,157670733,82670733,75000000
316,2015,Yip Man 3,157300954,2679437,154621517
317,1992,Under Siege,156563139,83563139,73000000
318,1989,Licence to Kill,156167015,34667015,121500000
319,2002,Blade 2,154338601,81676888,72661713
320,2004,Kill Bill: Volume 2,153535982,66207920,87328062
321,1990,Another 48 Hrs.,152747413,80047413,72700000
322,1985,A View to a Kill,152627960,50327960,102300000
323,2009,The Taking of Pelham 123,152364370,65452312,86912058
324,2013,47 Ronin,151716815,38362475,113354340
325,2022,RRR,150548288,14473124,136075164
326,1997,Speed 2: Cruise Control,150468000,48097081,102370919
327,1999,Mononoke-hime,150345863,2374107,147971756
328,2013,Lone Survivor,149804632,125095601,24709031
329,2012,Ghost Rider: Spirit of Vengeance,149217355,51774002,97443353
330,1996,Broken Arrow,148345997,70645997,77700000
331,2001,Swordfish,147080413,69772969,77307444
332,2017,The Foreigner,145374099,34393507,110980592
333,2001,The Mexican,145238250,66808615,78429635
334,2001,Spy Game,143049560,62362560,80687000
335,2017,Power Rangers,142531552,85364450,57167102
336,2013,RED 2,141507355,53262560,88244795
337,1995,Bad Boys,141247413,65647413,75600000
338,1965,Thunderball,141200000,63600000,77600000
339,1974,Towering Inferno,139700000,116000000,23700000
340,1988,Die Hard,139434346,81675242,57759104
341,2015,Lao pao er,139204612,1414696,137789916
342,1990,Bird on a Wire,138697012,70978012,67719000
343,1993,Last Action Hero,137298489,50016394,87282095
344,2017,American Made,135569212,51342000,84227212
345,2014,Myeong-ryang,133450917,2830989,130619928
346,2013,2 Guns,132493015,75612460,56880555
347,2023,Shazam! Fury of the Gods,132204280,57604280,74600000
348,2014,Jack Ryan: Shadow Recruit,131377412,50577412,80800000
349,2004,Blade: Trinity,131353165,52397389,78955776
350,1998,Blade,131237688,70141876,61095812
351,2016,Skiptrace,131202537,1792,131200745
352,2015,The Last Witch Hunter,130818912,27367660,103451252
353,2006,V for Vendetta,130214162,70511035,59703127
354,2008,The Forbidden Kingdom,129075270,52075270,77000000
355,2007,Aliens vs. Predator - Requiem,128884494,41797066,87087428
356,2012,Sap ji sang ciu,128230000,0,128230000
357,2000,U-571,127630030,77086030,50544000
358,2010,Predators,127234389,52000688,75233701
359,2019,Midway,126815030,56846802,69968228
360,2015,Point Break,126704591,28782481,97922110
361,2016,Mechanic: Resurrection,125729635,21218403,104511232
362,1982,First Blood,125212904,47212904,78000000
363,1982,Rocky III,125053490,125049125,4365
364,1964,Goldfinger,124900000,51100000,73800000
365,2018,Dragon Ball Super: Broly,122747755,30376755,92371000
366,2015,Tian jiang xiong shi,122519874,74070,122445804
367,1995,Mortal Kombat,122133227,70433227,51700000
368,2015,Bajrangi Bhaijaan,121778347,8178001,113600346
369,2021,The King’s Man,121125300,37176373,83948927
370,1997,Starship Troopers,121100000,54768952,66331048
371,2006,Apocalypto,121032272,50866635,70165637
372,2015,Tang ren jie tan an,120643551,459832,120183719
373,1987,Lethal Weapon,120192350,65192350,55000000
374,1997,Volcano,120100000,47546796,72553204
375,1990,Rocky V,119946358,40946358,79000000
376,2009,Surrogates,119668350,38577772,81090578
377,2009,Red Cliff,119627047,627047,119000000
378,2012,Hua Pi 2,118528842,33212,118495630
379,2018,The Commuter,118509836,36343858,82165978
380,1999,Blue Streak,117448157,68208190,49239967
381,1998,The Siege,116625798,40934175,75691623
382,2019,Geukhanjikeob,116127561,1565885,114561676
383,1971,Diamonds Are Forever,115999985,43800000,72199985
384,2019,Fan Tan Feng Bao 4,115687407,0,115687407
385,1986,"The Karate Kid, Part II",115103979,115103979,0
386,2018,Xi You Ji Nu Er Guo,115089944,187074,114902870
387,1995,Judge Dredd,113487912,34687912,78800000
388,2006,Underworld: Evolution,113417762,62318875,51098887
389,2008,Rambo,113244290,42754105,70490185
390,2019,The Gentlemen,113152222,36471796,76680426
391,2008,Transporter 3,112930957,31715062,81215895
392,1967,You Only Live Twice,111600000,43100000,68500000
393,2016,The 5th Wave,111336398,34912982,76423416
394,2022,Everything Everywhere All At Once,111308065,77169474,34138591
395,2017,Buddies in India,110203801,292662,109911139
396,2011,Sanctum,108957098,23209310,85747788
397,2015,The Man From U.N.C.L.E.,108517735,45445109,63072626
398,2014,Pompeii,108469033,23169033,85300000
399,2017,Along With The Gods: The Two Worlds,107476731,1908822,105567909
400,2000,Shaft,107190108,70327868,36862240
401,2014,The Breakup Guru,106798959,208959,106590000
402,2022,Beomjoidosi 2 (범죄도시2),106034955,613026,105421929
403,2022,Shen Tan Da Zhan (神探大战),105500000,0,105500000
404,2015,Chappie,105002056,31569268,73432788
405,2016,Cold War 2,104529486,560824,103968662
406,2002,The Tuxedo,104429625,50586000,53843625
407,1995,Under Siege 2: Dark Territory,104324083,50024083,54300000
408,2013,Gangster Squad,104100903,46000903,58100000
409,2021,Wrath of Man,103913405,27466489,76446916
410,2017,Wukong,103651195,0,103651195
411,2021,Meitantei Konan Hiiro no Dangan,102541050,0,102541050
412,1994,Timecop,102053581,44853581,57200000
413,2004,Kung Fu Hustle,102034104,17104669,84929435
414,2016,Railroad Tigers,101822673,218044,101604629
415,2022,Ming ri zhan ji,100730000,0,100730000
416,2004,Hellboy,99823958,59623958,40200000
417,1979,Mad Max,99750000,8750000,91000000
418,1994,Street Fighter,99423000,33423000,66000000
419,2007,Hitman,99135571,39687694,59447877
420,2021,Fan Tan Feng Bao (G風暴),98941096,0,98941096
421,2019,Shi Tu Xing Zhe 2 Die Ying Xing Dong,98444408,296751,98147657
422,2012,Contraband,98406855,66528000,31878855
423,1987,Predator,98267558,59735548,38532010
424,1974,The Man with the Golden Gun,97600000,21000000,76600000
425,2003,Once Upon a Time in Mexico,97413527,56330657,41082870
426,2007,TMNT,96096018,54149098,41946920
427,2000,The 6th Day,96024898,34543701,61481197
428,2003,Underworld,95708457,51970690,43737767
429,2010,Killers,95572749,47059963,48512786
430,2006,The Guardian,94973540,55011732,39961808
431,2015,Sha po long 2,94809560,0,94809560
432,2013,Riddick,94763758,42025135,52738623
433,2022,The Woman King,94374749,67328130,27046619
434,2018,Singwa Hamgge: Ingwa Yeon,93453434,1200246,92253188
435,2008,Speed Racer,93394462,43945766,49448696
436,2021,Shin Evangelion Gekijôban,93370370,826140,92544230
437,2004,House of Flying Daggers,92863945,11050094,81813851
438,2007,Gwoemul,92618117,2201923,90416194
439,2009,Underworld 3: Rise of the Lycans,92141886,45802315,46339571
440,2018,Jing Zhou,91462581,521396,90941185
441,2019,Rambo: Last Blood,91378886,44819352,46559534
442,2011,Season of the Witch,91126600,24827228,66299372
443,2000,Romeo Must Die,91036760,55973336,35063424
444,1984,The Karate Kid,90857623,90815558,42065
445,1976,King Kong,90614445,52614445,38000000
446,2015,Veteran,90498430,1155652,89342778
447,2018,Di Ren Jie Zhi Si Da Tian Wang,90035547,262963,89772584
448,2011,Sucker Punch,89758389,36392502,53365887
449,2016,Line Walker (使徒行者),89569657,0,89569657
450,1974,The Trial of Billy Jack,89000000,89000000,0
451,2005,The Transporter 2,88978458,43095856,45882602
452,2012,Brave Hearts Umizaru,88331372,0,88331372
453,2017,Chasing the Dragon,87969037,456854,87512183
454,1997,Spawn,87949859,54979992,32969867
455,2008,Max Payne,87775050,40689393,47085657
456,2012,Dodookdeul,86960532,532699,86427833
457,2007,The Kingdom,86802457,47467250,39335207
458,1979,Apocalypse Now,85959710,83535860,2423850
459,2003,Tears of the Sun,85632458,43632458,42000000
460,2018,Mortal Engines,85481904,15951040,69530864
461,2018,Robin Hood,85210012,30824628,54385384
462,2012,Long men fei jia,85130718,170276,84960442
463,1991,Point Break,83531958,43218387,40313571
464,2021,Mortal Kombat,83508259,42326031,41182228
465,1995,Assassins,83306268,30306268,53000000
466,2012,Act of Valor,82497035,70012847,12484188
467,2022,Xin Shen Bang: Yang Jian (新神榜：杨戬),82453728,0,82453728
468,2015,Hitman: Agent 47,82182803,22467450,59715353
469,2002,Reign of Fire,82150183,43061982,39088201
470,2004,Catwoman,82078046,40202379,41875667
471,1969,On Her Majesty's Secret Service,82000000,22800000,59200000
472,1988,Midnight Run,81613606,38413606,43200000
473,2015,Zhan Lang,81461069,0,81461069
474,2011,Drive,81357930,35060689,46297241
475,2014,Yi bu zhi yao,81300000,0,81300000
476,2013,Pain & Gain,81275291,49875291,31400000
477,2016,Underworld: Blood Wars,81209222,30353973,50855249
478,2003,The Rundown,80831893,47641743,33190150
479,2018,Den of Thieves,80147166,44947622,35199544
480,2001,Exit Wounds,79958599,51758599,28200000
481,2007,Dragon Wars: D-War,79915361,10977721,68937640
482,1986,The Golden Child,79817937,79817937,0
483,2017,Sha Po Lang: Tan Lang,79226860,0,79226860
484,1982,Conan the Barbarian,79114085,38264085,40850000
485,2013,R.I.P.D.,79076678,33618855,45457823
486,1964,From Russia With Love,78900000,24800000,54100000
487,2002,Collateral Damage,78353508,40048332,38305176
488,1984,The Terminator,78019031,38019031,40000000
489,2005,Hostage,77636443,34636443,43000000
490,2002,Windtalkers,77628265,40914068,36714197
491,1995,Money Train,77224232,35324232,41900000
492,2006,Man cheng jin dai huang jin jia,76904429,6566773,70337656
493,2017,Tiger Zinda Hai,76520376,5560921,70959455
494,2005,Stealth,76416746,32116746,44300000
495,2011,The Mechanic,76347393,29121498,47225895
496,2018,Sicario: Day of the Soldado,76346094,50065850,26280244
497,2014,John Wick,75958800,43037835,32920965
498,1982,48 Hrs.,75936265,75936265,0
499,2016,Shin Godjira,75614390,1908028,73706362
500,2012,Thermae Romae,75387554,0,75387554
501,2020,Jin Ji Jiu Yuan,74889133,0,74889133
502,2014,"I, Frankenstein",74575290,19075290,55500000
503,2003,The Core,74120792,31111260,43009532
504,2007,Next,73591500,18211013,55380487
505,2014,Brick Mansions,73421224,20396829,53024395
506,2019,Charlie’s Angels,73235048,17801306,55433742
507,2016,Sultan,72989781,5599781,67390000
508,2001,The One,72689126,43905746,28783380
509,2008,Death Race,72516819,36316032,36200787
510,2016,Tunnel,72460332,568876,71891456
511,2015,Run All Night,71561644,26461644,45100000
512,2005,XXX: State of the Union,71073932,26873932,44200000
513,1998,Ronin,70692101,41610884,29081217
514,2012,One Piece Film Z,70569231,0,70569231
515,2012,Odoru Daisôsasen the Final: Aratanaru kibô,70519044,0,70519044
516,2008,Babylon A.D.,70216497,22532572,47683925
517,1989,Star Trek V: The Final Frontier,70200000,52210049,17989951
518,2015,The Transporter Refueled,69698495,16029670,53668825
519,2022,Doragon boru supa supa hiro (ラゴンボール超 スーパーヒーロー)…,69476133,32132374,37343759
520,2022,The Northman,69474569,34233110,35241459
521,2002,Bad Company,69157016,30157016,39000000
522,2008,The X-Files: I Want to Believe,68170792,20982478,47188314
523,2004,Taxi,68109966,36609966,31500000
524,1983,Sudden Impact,67642693,67642693,0
525,2018,Mile 22,66295121,36108758,30186363
526,2016,One Piece Film: Gold,65796025,190859,65605166
527,2002,K-19: The Widowmaker,65716126,35168966,30547160
528,2006,16 Blocks,65595141,36895141,28700000
529,2011,Killer Elite,65409046,25124986,40284060
530,2021,Wu Xian Shen Du,64900464,0,64900464
531,2010,Haeundae,64733391,0,64733391
532,2017,Meitantei Konan: Kara Kurenai no Rabu Retta,64724172,0,64724172
533,2011,The Darkest Hour,64626786,21443494,43183292
534,2011,Tropa de Elite 2: O Inimigo Agora É Outro,64307758,100119,64207639
535,2015,Bai tuan da zhan,64220000,0,64220000
536,2015,Zhong Kui fu mo: Xue yao mo ling,64036296,165428,63870868
537,2018,L Feng Bao,63931005,0,63931005
538,1989,Tango & Cash,63408614,63408614,0
539,2011,Conan the Barbarian,63356133,21295021,42061112
540,2013,Kick-Ass 2,63129909,28795985,34333924
541,1997,The Peacemaker,62967368,41263140,21704228
542,2021,Sao Hei Jue Zhan,62810000,0,62810000
543,2000,Proof of Life,62761005,32598931,30162074
544,2009,Ninja Assassin,62209892,38122883,24087009
545,2014,A Walk Among the Tombstones,62108587,26017685,36090902
546,2015,Bai Fa Mo Nu Zhuan Zhi Ming Yue Tian Guo,61850000,0,61850000
547,1999,The 13th Warrior,61698899,32698899,29000000
548,2017,The Founding of an Army,60600360,0,60600360
549,2002,I Spy,60279822,33561137,26718685
550,1963,Dr. No,59567035,16067035,43500000
551,1991,The Last Boy Scout,59509925,59509925,0
552,2019,Baekdusan,59505509,372562,59132947
553,2022,Moonfall,59053195,19060660,39992535
554,2001,Behind Enemy Lines,58855732,58855732,0
555,2017,Chāi dàn zhuānjiā,58807172,0,58807172
556,2015,Doragon bôru Z: Fukkatsu no 'F',58408363,8008363,50400000
557,1981,The Cannonball Run,57498710,57498710,0
558,2019,Zhu Xian,56911144,0,56911144
559,2005,Elektra,56824633,24409722,32414911
560,1980,The Final Countdown,56647800,16647800,40000000
561,2022,Hansan Yongeui Chulhyeon (한산: 용의 출현),56525688,865888,55659800
562,2017,Confidential Assignment,56450663,475618,55975045
563,2003,Cradle 2 the Grave,56434942,34657731,21777211
564,2007,We Own the Night,55307857,28563179,26744678
565,1990,Predator 2,54768418,28317513,26450905
566,2001,Driven,54616869,32616869,22000000
567,2003,National Security,54599300,36288951,18310349
568,2004,The Punisher,54533774,33664370,20869404
569,2016,The Age of Shadows (밀정),54500169,540268,53959901
570,1987,RoboCop,54125172,53424681,700491
571,2005,Aeon Flux,53913573,25857987,28055586
572,2015,Hollywood Adventures,53246837,0,53246837
573,2011,Choi-jong-byeong-gi-hwal,52760691,40685,52720006
574,1993,Nowhere to Run,52189039,22189039,30000000
575,2017,The Outlaws,52097753,0,52097753
576,2018,Peppermint,51800758,35418723,16382035
577,1996,Maximum Risk,51702929,14102929,37600000
578,2013,Homefront,51695362,20158492,31536870
579,1992,Sneakers,51433000,51433000,0
580,1997,Mortal Kombat: Annihilation,51327406,35927406,15400000
581,1978,Hooper,51290536,51290536,0
582,2011,Bodyguard,51119758,1834384,49285374
583,1994,The Crow,51094306,50638075,456231
584,2016,Master,51007693,584298,50423395
585,1977,A Bridge Too Far,50800000,50800000,0
586,2013,Feng Bao,50770000,0,50770000
587,2003,Hollywood Homicide,50409753,30207785,20201968
588,2012,Red Tails,50365498,49876377,489121
589,1962,The Longest Day,50100000,39100000,11000000
590,2011,Ip Man: Legend of the Grand Master,49721954,205675,49516279
591,2016,Operation Chromite,49196532,1022720,48173812
592,1998,The Negotiator,49105766,44705766,4400000
593,1986,Cobra,49042224,49042224,0
594,2005,Danny the Dog,49037621,24537621,24500000
595,2018,Death Wish,48575965,34017028,14558937
596,2013,The Last Stand,48330757,12050299,36280458
597,2013,Bereurlin,48314840,0,48314840
598,2012,Red Dawn,48164150,44806783,3357367
599,2017,Kōng tiān liè,48069252,0,48069252
600,2020,I’m From Today!,47895889,0,47895889
601,2017,Ji Qi Zhi Xue,47872755,0,47872755
602,2004,Walking Tall,47856383,46213824,1642559
603,2023,Plane,47855350,32111181,15744169
604,2020,Monster Hunter,47853893,15162470,32691423
605,1991,New Jack City,47624253,47624253,0
606,1990,Hard To Kill,47381527,47381386,141
607,2003,The Hunted,47213095,34234008,12979087
608,1993,Fortress,46730578,6730578,40000000
609,1988,Colors,46616067,46616067,0
610,2008,Bangkok Dangerous,46598133,15298133,31300000
611,1991,The Rocketeer,46573027,46573027,0
612,2010,Machete,46370970,26593646,19777324
613,2017,Qi Man Dun Jia,46263233,124187,46139046
614,1976,The Enforcer,46200000,46200000,0
615,2004,Torque,46176322,21176322,25000000
616,2018,Huang Jin Xiong Di,46165078,285795,45879283
617,2020,Ji Xian Feng,45986345,793525,45192820
618,1982,Firefox,45785720,45785720,0
619,2017,Gintama,45776563,0,45776563
620,2019,Zhui Long 2: Zhui Ji Da Fu Hao,45738461,196634,45541827
621,2017,Xin Li Zui,45698504,0,45698504
622,1990,RoboCop 2,45681173,45681173,0
623,1991,Thelma & Louise,45459688,45361000,98688
624,1978,Convoy,45000000,45000000,0
625,1973,Magnum Force,44680473,44680473,0
626,2011,Ra. One,44549121,2509150,42039971
627,2010,Shi Yue Wei Cheng,44195779,0,44195779
628,1992,Passenger 57,44065653,44065653,0
629,2002,The Transporter,43928932,25296447,18632485
630,2006,Crank,43924923,27838408,16086515
631,2003,A Man Apart,43797731,26500000,17297731
632,2016,Feng Shen Bang,43415987,143430,43272557
633,2021,Rurôni Kenshin: Sai shûshô - The Final,43384254,0,43384254
634,1990,Marked for Death,43224499,43224499,0
635,2006,Tom yum goong,43044087,12044087,31000000
636,1986,Heartbreak Ridge,42724017,42724017,0
637,1983,Blue Thunder,42313354,42313354,0
638,1968,Bullitt,42300945,42300873,72
639,2010,Joheunnom nabbeunnom isanghannom,42226657,128486,42098171
640,2009,Gamer,42002029,20534907,21467122
641,2019,Masukarêdo hoteru,41885312,0,41885312
642,2012,Meitantei Conan: Juichi-ninme no Striker,41863105,0,41863105
643,2018,Ansisung,41754733,472166,41282567
644,2012,Safe,41495213,17142080,24353133
645,2012,Dredd,41467606,13414714,28052892
646,1997,Money Talks,41076865,41076865,0
647,2011,Drive Angry,41042583,10721033,30321550
648,2007,War,40686409,22486409,18200000
649,2014,Sin City: A Dame to Kill For,40650842,13757804,26893038
650,2010,Ajeossi,40650572,0,40650572
651,2015,Yeonpyeonghaejeon,40380376,0,40380376
652,2005,Serenity,40319440,25514517,14804923
653,2017,xiu chun dao II: xiu luo zhan chang,39965792,14204,39951588
654,2009,Cirque du Freak: The Vampire's Assistant,39753957,14046595,25707362
655,2017,Cheongnyeon Gyeongchal,39737402,0,39737402
656,1991,Out for Justice,39673161,39673161,0
657,2006,Dhoom 2,39643586,2643586,37000000
658,2008,Never Back Down,39319801,24850922,14468879
659,2018,Overlord,39178189,21704844,17473345
660,2008,The Spirit,39006188,19806188,19200000
661,2011,The Eagle,38993548,19490041,19503507
662,1984,Red Dawn,38900000,38900000,0
663,2010,Tau ming chong,38899792,129078,38770714
664,2007,Dnevnoy dozor,38870910,459095,38411815
665,2013,Doragon Bōru Zetto Kami to Kami,38848780,0,38848780
666,1989,"The Karate Kid, Part III",38793278,38793278,0
667,2015,Criminal,38771262,14708696,24062566
668,2021,Jin Qian Di Guo Zhui: Hu Qin Long,38611941,0,38611941
669,1994,On Deadly Ground,38590458,38590458,0
670,1996,The Ghost and the Darkness,38564422,38564422,0
671,2016,"Crouching Tiger, Hidden Dragon: Sword of Destiny",38452981,0,38452981
672,2014,Bang Bang,38381138,2581138,35800000
673,1984,City Heat,38348988,38348988,0
674,2004,After the Sunset,38329114,28328132,10000982
675,1987,The Running Man,38122000,38122000,0
676,1988,The Dead Pool,37903000,37903000,0
677,2016,Mission Milano,37834435,0,37834435
678,2019,Bloodshot,37163054,10021787,27141267
679,2019,Fan Zui Xian Chang,37092694,0,37092694
680,2001,Kiss of the Dragon,36833473,36833473,0
681,1972,The Getaway,36734619,36734619,0
682,1987,Superman IV: The Quest for Peace,36700000,14522355,22177645
683,1996,The Glimmer Man,36404841,20404841,16000000
684,2017,Raid Dingue,36360000,0,36360000
685,1992,Universal Soldier,36299898,36299898,0
686,1996,Rumble in the Bronx,36238752,32281907,3956845
687,1985,Mad Max Beyond Thunderdome,36230219,36230219,0
688,2005,Assault On Precinct 13,36040895,20040895,16000000
689,2006,Wu ji,35869934,669625,35200309
690,2010,Faster,35792945,23240020,12552925
691,1977,The Gauntlet,35400000,35400000,0
692,1985,Commando,35078913,35073978,4935
693,2011,Shaolin,35066099,66099,35000000
694,1988,Red Heat,34994648,34994648,0
695,2021,Snake Eyes: G.I. Joe Origins,34677221,28264325,6412896
696,2012,Ta-weo,34411903,726,34411177
697,2011,Don 2,34053090,3674480,30378610
698,2006,Nochnoy dozor,33913542,1502188,32411354
699,2022,Detective Conan: The Bride of Halloween,33777282,0,33777282
700,2013,Gamshijadeul,33551732,0,33551732
701,2000,Red Planet,33463969,17480890,15983079
702,1996,The Long Kiss Goodnight,33447612,33447612,0
703,1968,Planet of the Apes,33398936,33395426,3510
704,2015,Chek dou,33349429,0,33349429
705,2017,Gangcheolbi,33276122,0,33276122
706,1985,The Last Dragon,33000447,33000000,447
707,1990,Darkman,32942739,32942739,0
708,1990,Air America,32914515,30506847,2407668
709,2009,Fighting,32831707,23091010,9740697
710,2019,Anna,32825217,7743794,25081423
711,2022,heonteu (헌트),32687164,25994,32661170
712,2012,Fetih 1453,32481209,0,32481209
713,2006,Krrish,32430721,1430721,31000000
714,2018,Baaghi 2,32408855,1319579,31089276
715,2012,Agneepath,32186870,1973574,30213296
716,2011,Bai she chuan shuo,32142621,18759,32123862
717,1992,The Lawnmower Man,32100816,32100816,0
718,2013,Man Tam,32061558,0,32061558
719,1997,Metro,32017895,32017895,0
720,2016,Bounty Hunters,31956249,0,31956249
721,1994,The Shadow,31835600,31835600,0
722,1998,Mr. Nice Guy,31716953,12716953,19000000
723,1993,Hard Target,31636358,31636358,0
724,2010,Robot,31267492,2276427,28991065
725,2023,Long Ma Jing Shen (龙马精神),31047409,64759,30982650
726,2006,Ultraviolet,30962112,18522064,12440048
727,2004,Zatoichi,30874550,853718,30020832
728,2007,Pathfinder,30822861,10232081,20590780
729,2018,Gintama 2: Okite wa Yaburu tame ni koso Aru,30798089,0,30798089
730,1999,Virus,30626690,14010690,16616000
731,2009,Chi Bi Juezhan Tianxia,30500000,0,30500000
732,2016,S Storm,30463603,0,30463603
733,2015,Mortdecai,30396134,7696134,22700000
734,2004,Silmido,30298347,298347,30000000
735,1989,Road House,30050028,30050028,0
736,2008,The Chaser,30049670,0,30049670
737,1975,Rollerball,30000000,30000000,0
738,2017,Ni Shi Ying Jiu,29945246,108970,29836276
739,2010,The Losers,29863840,23591432,6272408
740,2021,Mogadisyu,29848779,342598,29506181
741,2001,Double Take,29823162,29823162,0
742,2019,Gekijô-ban poketto monsutâ - Myûtsû no gyakushû…,29753435,0,29753435
743,2000,Battlefield Earth: A Saga of the Year 3000,29725663,21471685,8253978
744,2006,Taepung,29592720,139059,29453661
745,2012,Si da ming bu,29567632,0,29567632
746,2013,Race 2,29476034,1579940,27896094
747,2008,Singh is Kinng,29339790,2523511,26816279
748,1994,A Low Down Dirty Shame,29317886,29317886,0
749,2013,Meitantei Konan Zekkai no Puraibēto Ai,29302051,0,29302051
750,1988,Shoot to Kill,29300000,29300000,0
751,2012,Wu Xia,29284214,11300,29272914
752,2015,Jie jiu wu xian sheng,29201927,92696,29109231
753,2022,The Unbearable Weight of Massive Talent,29116320,20300157,8816163
754,2016,Viking,29099751,0,29099751
755,1991,Double Impact,29090445,29090445,0
756,1992,3 Ninjas,29028000,29028000,0
757,2001,Heist,28906817,23483357,5423460
758,2012,Baramgwa hamjje sarajida,28686545,0,28686545
759,1994,Drop Zone,28607015,28607015,0
760,2015,Shingeki no kyojin,28528388,258794,28269594
761,2020,Soul Snatcher,28501108,0,28501108
762,2014,Sin-ui Hansu,28211214,0,28211214
763,1971,Dirty Harry,28153434,28153434,0
764,2011,Huà Bì,28134879,0,28134879
765,2018,Thugs of Hindostan,27942770,1449848,26492922
766,1983,Uncommon Valor,27900000,27900000,0
767,2008,RocknRolla,27794339,5700626,22093713
768,2023,Operation Fortune: Ruse de guerre,27542984,6496125,21046859
769,1984,Dune,27503491,27447471,56020
770,1981,Victory,27453000,10853000,16600000
771,2015,Detective K: Secret of the Lost Island,27230725,0,27230725
772,1980,Flash Gordon,27176976,27107960,69016
773,1998,The Big Hit,27073371,27066941,6430
774,2021,Chaos Walking,27072169,13287908,13784261
775,2003,Bulletproof Monk,26922492,23010607,3911885
776,1982,Tron,26919100,26918576,524
777,2011,Jing mo fung wan: Chen Zhen,26822441,50433,26772008
778,2017,Judwaa 2,26797432,1431255,25366177
779,2007,Shoot 'Em Up,26796824,12796824,14000000
780,2015,Baahubali: The Beginning,26736665,6738000,19998665
781,2008,Gonggongui jeog 3,26497132,0,26497132
782,1984,Conan the Destroyer,26400000,26400000,0
783,1995,Fair Game,26097497,11497497,14600000
784,2022,Sǎo Hēi Xíng Dòng (扫黑行动),25880000,0,25880000
785,2002,Rollerball,25852508,18990542,6861966
786,2019,Akinjeon,25561514,216494,25345020
787,1996,Escape from L.A.,25426861,25426861,0
788,2012,逆战 (Jik zin),25414221,0,25414221
789,2007,The Last Legion,25357771,5932060,19425711
790,1981,Escape from New York,25275289,25244700,30589
791,2008,Race,25195835,1367024,23828811
792,2011,Ivan Tsarevich i Seryy Volk,25047727,0,25047727
793,2016,Call of Heroes,25040561,0,25040561
794,2013,Te shu shen fen,25040000,0,25040000
795,1974,Thunderbolt and Lightfoot,25000000,25000000,0
796,2006,Kurtlar vadisi - Irak,24906717,0,24906717
797,2022,Bian Yuan Xing Zhe (边缘行者),24860818,0,24860818
798,2019,Tian Huo Wei Qing,24825246,1105,24824141
799,1990,Navy SEALs,24824126,24824126,0
800,2012,Tai Chi Zero,24790553,212094,24578459
801,1981,Mad Max 2: The Road Warrior,24601332,24600832,500
802,2015,Bou Chau Mai Sing,24405298,32053,24373245
803,2018,Manyeo,24217796,0,24217796
804,1986,Iron Eagle,24159872,24159872,0
805,2005,Ong-Bak,24051852,4563167,19488685
806,1995,Virtuosity,23998226,23998226,0
807,2021,The Marksman,23855847,15566093,8289754
808,2012,Da Shang Hai,23824720,0,23824720
809,1993,Striking Distance,23798623,23798623,0
810,2008,"OSS 117: Le Caire, nid d'espions",23726360,303328,23423032
811,2005,Domino,23574057,10169202,13404855
812,2012,Xiao Shi De Zi Dan,23490000,0,23490000
813,2000,Reindeer Games,23360779,23360779,0
814,2017,CHiPS,23190292,18600152,4590140
815,1984,Missing in Action,22812411,22812411,0
816,2019,Shéntàn púsōng líng,22799838,0,22799838
817,2019,Black and Blue,22730144,22012729,717415
818,2012,Raia Gemu Saisei,22713078,0,22713078
819,2017,Extraordinary Mission,22682660,0,22682660
820,2013,Seupai,22614450,0,22614450
821,2013,Bullet to the Head,22597969,9489829,13108140
822,1991,Lionheart,22545360,22545360,0
823,1979,The Warriors,22490943,22490000,943
824,2009,Chernaya Molniya,22435112,0,22435112
825,2018,Yun Nan Chong Gu Yunnan Valley,22369964,101516,22268448
826,1996,Bulletproof,22230840,21195840,1035000
827,1984,The Last Starfighter,22200789,22200789,0
828,2006,The Marine,22165608,18844784,3320824
829,2010,Three Kingdoms: Resurrection of the Dragon,22139590,0,22139590
830,2009,Ip Man,22114423,0,22114423
831,2003,The Medallion,22108977,22108977,0
832,2003,Biker Boyz,22105310,21908034,197276
833,1989,Lock Up,22099847,22099847,0
834,2012,Solomon Kane,22024849,0,22024849
835,2012,The Man with the Iron Fists,22018988,15634090,6384898
836,1974,Death Wish,22000000,22000000,0
837,2015,Pokémon the Movie XY: Ring no Chomajin Hoopa,21786128,0,21786128
838,2018,Proud Mary,21709539,20868638,840901
839,1990,The Rookie,21633874,21633874,0
840,2008,Doomsday,21621188,11008770,10612418
841,1996,The Quest,21607190,21607190,0
842,2017,The Prison,21522551,207481,21315070
843,1973,Enter the Dragon,21485066,21483063,2003
844,2007,Arn - Tempelriddaren,21404122,0,21404122
845,2022,Devotion,21398489,20511938,886551
846,2021,Rurôni Kenshin: Sai shûshô — The Beginning,21318560,0,21318560
847,1991,F/X2,21075831,21075831,0
848,1997,The Postman,20841123,17650704,3190419
849,2006,Alex Rider: Operation Stormbreaker,20722450,659210,20063240
850,1986,F/X,20603715,20603715,0
851,1985,Code of Silence,20345361,20345361,0
852,1988,Action Jackson,20257000,20257000,0
853,1995,Sudden Death,20214270,20214270,0
854,1979,A Force of One,20200000,20200000,0
855,2018,Gu Jian Qi Tan Zhi Liu Yue Zhao Ming,20079528,0,20079528
856,2013,Tai Chi Hero,20016042,30830,19985212
857,1981,Outland,20000000,20000000,0
858,1983,Breathless,19910002,19910002,0
859,1996,Fled,19892205,17192205,2700000
860,1998,Hard Rain,19870567,19870567,0
861,1987,Innerspace,19816619,19816619,0
862,2018,Ye Wen hui chuan: Zhang Tianzhi,19781947,209454,19572493
863,1992,Kuffs,19618135,19618135,0
864,2012,Go-ji-jeon,19603449,0,19603449
865,1981,Nighthawks,19600000,14600000,5000000
866,2000,Get Carter,19417182,14967182,4450000
867,2002,Half Past Dead,19233280,15567860,3665420
868,2021,The Tomorrow War,19220000,0,19220000
869,1998,The Replacement Killers,19035741,19035741,0
870,1995,Johnny Mnemonic,19006201,19006201,0
871,1980,The Octagon,19000000,19000000,0
872,2011,The Heir Apparent: Largo Winch,18967760,10352,18957408
873,1988,Above the Law,18869631,18869631,0
874,2016,Asura : The City of Madness,18736628,174501,18562127
875,2011,Jûsan-nin no shikaku,18727440,802778,17924662
876,2001,3000 Miles to Graceland,18708848,15738632,2970216
877,1985,Year of the Dragon,18707466,18707466,0
878,1985,Ladyhawke,18400000,18400000,0
879,2014,Sabotage,18376443,10508518,7867925
880,2017,Zhui bu,18339343,0,18339343
881,1978,Good Guys Wear Black,18300000,18300000,0
882,2013,Machete Kills,18273009,8008161,10264848
883,2010,Repo Men,18195238,13942007,4253231
884,1996,Last Man Standing,18149997,18115927,34070
885,2012,Stolen,17967746,289773,17677973
886,2017,Shinobi no kuni,17952504,0,17952504
887,1996,The Crow: City of Angels,17897671,17897671,0
888,2015,Brothers,17856688,656688,17200000
889,2021,Monkey King Reborn,17692630,0,17692630
890,2015,The Accidental Detective,17624124,0,17624124
891,1985,Invasion U.S.A.,17536256,17536256,0
892,1970,Beneath the Planet of the Apes,17489009,17489009,0
893,1987,Masters of the Universe,17336370,17336370,0
894,1985,To Live and Die in L.A.,17307019,17307019,0
895,2009,12 Rounds,17306648,12234694,5071954
896,2017,Jiao Zhu Chuan,17283136,13588,17269548
897,1996,The Phantom,17220599,17220599,0
898,1991,Hudson Hawk,17218916,17218916,0
899,1994,No Escape,17213233,15339030,1874203
900,2016,Hardcore Henry,17187434,9252038,7935396
901,1993,Sidekicks,17180393,17180393,0
902,1992,Freejack,17033142,17033142,0
903,2015,Boruto: Naruto the Movie,17014551,259028,16755523
904,1986,The Delta Force,17005599,17005599,0
905,2007,Death Sentence,16907831,9534258,7373573
906,2020,Hiteumaen,16821116,0,16821116
907,2017,Salyut-7,16755928,0,16755928
908,1992,Deep Cover,16639799,16639799,0
909,2009,Der Baader Meinhof Komplex,16498827,476270,16022557
910,1994,Terminal Velocity,16478900,16478900,0
911,2019,Archimedes no Taisen,16454674,0,16454674
912,1986,Howard the Duck,16295774,16295774,0
913,1996,Supercop,16270600,16270600,0
914,2008,Dasavatharam,16227750,0,16227750
915,1986,Raw Deal,16209459,16209459,0
916,1997,Fire Down Below,16148906,16148906,0
917,1985,Death Wish 3,16116878,16116878,0
918,1982,Death Wish II,16100000,16100000,0
919,1989,No Holds Barred,16093651,16093651,0
920,1987,Over the Top,16057580,16057580,0
921,2022,Blacklight,16017096,9591094,6426002
922,2015,Gangnam 1970,16016282,0,16016282
923,1965,Our Man Flint,16000000,16000000,0
924,1975,Breakout,16000000,16000000,0
925,2019,Shinui Han Soo: Gwisoopyeon,15993710,67578,15926132
926,1989,Next of Kin,15942628,15942628,0
927,1994,The Next Karate Kid,15851228,8751228,7100000
928,2021,Gintama: The Final,15775367,0,15775367
929,2010,Once Upon a Time in Mumbai,15753012,302862,15450150
930,1994,The Getaway,15545115,15545115,0
931,2000,Bait,15471969,15325127,146842
932,1999,The Mod Squad,15415361,13260050,2155311
933,1990,Death Warrant,15394200,15394200,0
934,2019,Miss Bala,15364632,14998027,366605
935,2012,Autoreiji: Biyondo,15233433,3878,15229555
936,2017,Kureyon Shinchan: Shūrai! Uchūjin Shiriri,15227612,0,15227612
937,2017,North East: Past Po Ma Zhang Fei,15208575,0,15208575
938,2019,The Fable,15184913,0,15184913
939,1999,The Corruptor,15164492,15164492,0
940,2014,Shingeki no kyojin endo obu za wârudo,15161611,243356,14918255
941,2016,Three,15143255,119550,15023705
942,2016,Pitbull: Niebezpieczne Kobiety,15118739,0,15118739
943,1991,Toy Soldiers,15073942,15073942,0
944,2009,Obitaemyy ostrov,15000000,0,15000000
945,2019,Cui mian · cai jue,14917516,0,14917516
946,2017,The Game Changer,14875966,0,14875966
947,2022,Serdtse parmy (Сердце пармы),14845677,0,14845677
948,1990,Fire Birds,14760451,14760451,0
949,2020,Ogon,14746111,0,14746111
950,2001,Iron Monkey,14681661,14681661,0
951,2018,Blood-Soaked GuangChang,14651659,0,14651659
952,2016,Sword Master,14630563,75526,14555037
953,1998,Soldier,14623082,14623082,0
954,1997,Jackie Chan’s First Strike,14601662,14601662,0
955,2016,High & Low: The Movie,14590783,0,14590783
956,1989,Kickboxer,14533681,14533681,0
957,1991,Flight of the Intruder,14471440,14471440,0
958,2018,Mayakwang,14446477,0,14446477
959,1992,Rapid Fire,14356479,14356479,0
960,2008,Tropa de Elite,14319195,8744,14310451
961,2002,Ballistic: Ecks vs. Sever,14294842,14294842,0
962,1975,The Eiger Sanction,14200000,14200000,0
963,1991,Highlander II: The Quickening,14184134,14184134,0
964,2004,Taegeugki: Hwinalrimyeo,14080854,0,14080854
965,1991,The Perfect Weapon,14061361,14061361,0
966,2013,Shootout at Wadala,14038660,369310,13669350
967,2012,Hong men yan,13969132,0,13969132
968,2017,The Missing,13887720,0,13887720
969,2016,I am a Hero,13756682,0,13756682
970,1992,Trespass,13747138,13747138,0
971,1995,Highlander: The Final Dimension,13738574,13738574,0
972,1998,Desperate Measures,13678274,13678274,0
973,2020,Dam bo,13566238,0,13566238
974,2019,Dabangg 3,13553861,535000,13018861
975,2019,bbaengban,13551495,0,13551495
976,2012,Tomorrow When the War Began,13404936,4936,13400000
977,2023,Gyoseob (교섭),13325763,0,13325763
978,2008,In the Name of the King: A Dungeon Siege Tale,13233220,4775656,8457564
979,2021,OSS 117: Alerte rouge en Afrique noire,13215361,0,13215361
980,1984,The Evil That Men Do,13106767,13102025,4742
981,2018,Kobiety Mafii,13100948,0,13100948
982,2016,Saraba Abunai Deka: Long Goodbye,13074758,0,13074758
983,2000,The Way of the Gun,13061935,6047856,7014079
984,2017,Boolhandang: Nabbeun Nomdeului Sesang,13061089,0,13061089
985,2020,Jeongsang hoidam,12918661,0,12918661
986,2016,Seondal: The Man who Sells the River,12902072,97223,12804849
987,1986,Highlander,12900000,5900000,7000000
988,1998,Black Dog,12857351,12857351,0
989,2000,Highlander: Endgame,12801190,12801190,0
990,1999,The Omega Code,12678312,12610552,67760
991,2009,Street Fighter: The Legend of Chun-Li,12660287,8742261,3918026
992,2002,Extreme Ops,12624471,4835968,7788503
993,2018,PMC: deo beong-keo,12478635,0,12478635
994,2018,Kamen Raidâ Heisei Jenerêshonzu Foebâ,12465928,0,12465928
995,2007,Boy s tenyu 2,12426015,0,12426015
996,2022,Memory,12390986,7329043,5061943
997,2008,Shaolin Girl,12380512,0,12380512
998,2008,Eye for an Eye,12314832,0,12314832
999,1971,Escape from the Planet of the Apes,12300000,12300000,0
"1,000",1971,Shaft,12121618,12121618,0
"1,001",1987,Fatal Beauty,12046526,12046526,0
"1,002",2017,Outrage Coda,11983269,0,11983269
"1,003",2019,City Hunter: Shinjuku Private Eyes,11960955,0,11960955
"1,004",2013,Duong Gia Tuong,11906509,0,11906509
"1,005",2018,Sungnan Hwangso,11872000,101417,11770583
"1,006",1991,Year of the Gun,11820000,11820000,0
"1,007",1988,Bloodsport,11806119,11806119,0
"1,008",1994,3 Ninjas Kick Back,11744960,11744960,0
"1,009",2013,Dhoom 3,11723620,8031955,3691665
"1,010",2006,Banlieue 13,11599903,1200216,10399687
"1,011",1999,Wing Commander,11578022,11578022,0
"1,012",2018,Wu Lin Guai Shou,11573104,0,11573104
"1,013",2000,The Legend of Drunken Master,11546543,11546543,0
"1,014",2022,wigyein 1bu (외계+인 1부),11443544,168309,11275235
"1,015",2018,Thaanaa Serndha Koottam,11383175,0,11383175
"1,016",2012,Reign of Assassins,11354230,0,11354230
"1,017",1997,Double Team,11328565,11328565,0
"1,018",2021,The Fable: Chapter Two,11325545,0,11325545
"1,019",1987,Extreme Prejudice,11307844,11307844,0
"1,020",2013,Toshokan Senso,11294442,0,11294442
"1,021",1991,One Good Cop,11276846,11276846,0
"1,022",1999,Chill Factor,11263966,11263966,0
"1,023",2017,Overdrive,11247280,0,11247280
"1,024",1986,Big Trouble in Little China,11208967,11100000,108967
"1,025",1998,Deep Rising,11203026,11203026,0
"1,026",2015,Daeho,11172111,0,11172111
"1,027",2018,Agnyaathavaasi,11158499,0,11158499
"1,028",1984,Tank,11131530,11131530,0
"1,029",2010,Jonah Hex,11022696,10547117,475579
"1,030",2020,Tsumi no Koe,10983063,0,10983063
"1,031",2017,High & Low The Movie 2 / End of Sky,10956658,0,10956658
"1,032",2001,Le pacte des loups,10948572,10948572,0
"1,033",2013,Himmatwala,10871870,270880,10600990
"1,034",2019,The Courier,10862201,0,10862201
"1,035",2015,Hei Mao Jing Zhang Zhi Fei Cui Zhi Xing,10849131,0,10849131
"1,036",2019,Saja,10776117,102982,10673135
"1,037",1985,Missing in Action 2: The Beginning,10755447,10755447,0
"1,038",1982,The Beastmaster,10751126,10751126,0
"1,039",2021,Realm of Terracotta,10740000,0,10740000
"1,040",2017,Ajin,10735896,0,10735896
"1,041",1999,Universal Soldier II: The Return,10717421,10447421,270000
"1,042",1993,RoboCop 3,10696210,10696210,0
"1,043",1989,The Package,10647219,10647219,0
"1,044",2006,A Dirty Carnival,10638098,0,10638098
"1,045",2009,The Boondock Saints 2: All Saints Day,10629320,10273187,356133
"1,046",2005,The Great Raid,10597070,10166502,430568
"1,047",2015,Deo Pon,10510802,0,10510802
"1,048",1985,American Ninja,10499000,10499000,0
"1,049",2017,Baadshaho,10497601,0,10497601
"1,050",1982,Silent Rage,10490791,10490791,0
"1,051",2004,Steamboy,10468867,468867,10000000
"1,052",1997,Operation Condor,10461161,10461161,0
"1,053",2017,Kolovrat,10424668,0,10424668
"1,054",2013,Jeonseolui Joomeok,10388780,134213,10254567
"1,055",2018,Kin,10383524,5718096,4665428
"1,056",2018,Long Xia Xing Jing,10381054,85172,10295882
"1,057",1983,Revenge of the Ninja,10325628,10325628,0
"1,058",1998,Knock Off,10319915,10319915,0
"1,059",2017,Kamen Raidâ Heisei Jenerêshonzu Fainaru: Birudo…,10289397,0,10289397
"1,060",2017,Kuang Shou,10217493,0,10217493
"1,061",1999,Hak Hap,10211278,10211278,0
"1,062",2008,Punisher: War Zone,10157534,8050977,2106557
"1,063",2018,Ying Xiong Ben Se 2018,10079961,0,10079961
"1,064",1988,Shakedown,10068039,10068039,0
"1,065",1993,Boiling Point,10058318,10058318,0
"1,066",2000,Godzilla 2000,10037390,10037390,0
"1,067",1989,Cyborg,10030875,10030875,0
"1,068",2012,For Greater Glory: The True Story of Cristiada,10026255,5669081,4357174
"1,069",2016,Tamjung Hong Gil-dong: Sarajin Ma-eul,10020965,67054,9953911
"1,070",1988,Iron Eagle II,10000000,10000000,0
"1,071",1972,Shaft’s Big Score,10000000,10000000,0
"1,072",1986,Murphy's Law,9947631,9947631,0
"1,073",2022,Haejeok doggaebi gitbal (해적: 도깨비 깃발),9888157,0,9888157
"1,074",2011,Badrinath,9818936,0,9818936
"1,075",2017,Peace Breaker,9796094,0,9796094
"1,076",2017,The War of Loong,9782949,0,9782949
"1,077",2006,Running Scared,9729088,6855137,2873951
"1,078",1984,Cloak & Dagger,9719952,9719952,0
"1,079",2023,Dyun Mong (断网),9605591,0,9605591
"1,080",2017,God of War,9560020,53496,9506524
"1,081",2020,Okei! Madam,9529935,0,9529935
"1,082",2011,Salvando al Soldado Perez,9330465,1400726,7929739
"1,083",2012,Serbuan maut,9297407,4105123,5192284
"1,084",1991,Stone Cold,9286314,9286314,0
"1,085",2022,Kesisme: Iyi Ki Varsin Eren,9279013,0,9279013
"1,086",2017,Zashchitniki,9043794,0,9043794
"1,087",1989,Renegades,9015164,9015164,0
"1,088",2016,Super Express,8980243,0,8980243
"1,089",1983,Deathstalker,8890685,8890685,0
"1,090",2016,Bastille Day,8831974,50269,8781705
"1,091",2017,Aknyeo,8830002,27741,8802261
"1,092",1985,Gotcha,8823269,8823269,0
"1,093",1973,Battle for the Planet of the Apes,8800000,8800000,0
"1,094",2016,Chô kôsoku! Sankin kôtai ritânzu,8763957,0,8763957
"1,095",2019,Chui Shao Ren,8719427,150481,8568946
"1,096",2023,Guy Ritchie’s The Covenant,8678963,8678963,0
"1,097",1980,The Big Brawl,8527743,8527743,0
"1,098",2021,Way Down,8452720,0,8452720
"1,099",2019,War,8436133,3640355,4795778
"1,100",2001,John Carpenter’s Ghosts of Mars,8434601,8434601,0
"1,101",1979,Meteor,8400000,8400000,0
"1,102",1997,Turbo: A Power Rangers Movie,8363899,8363899,0
"1,103",2007,"Gekijô-ban Kamen Raidâ Den-Ô: Ore, tanjô!",8353721,0,8353721
"1,104",2016,Siganitalga (시간이탈자),8339975,58689,8281286
"1,105",1999,Twin Dragons,8332431,8332431,0
"1,106",2015,Batalon,8292235,0,8292235
"1,107",2012,Tong que tai,8264881,0,8264881
"1,108",2018,A.X.L.,8259753,6501381,1758372
"1,109",2021,The Protégé,8256029,7446823,809206
"1,110",2019,Code Geass: Fukkatsu No Lelouch,8189684,0,8189684
"1,111",2009,BLUE,8125973,321640,7804333
"1,112",1998,Firestorm,8123860,8123860,0
"1,113",2010,Veer,8049862,527193,7522669
"1,114",2018,Black Water,8023159,0,8023159
"1,115",2012,The Sweeney,8000366,26345,7974021
"1,116",1948,The Three Musketeers,8000000,8000000,0
"1,117",1968,The Devil's Brigade,8000000,8000000,0
"1,118",1985,Runaway Train,7936012,7936012,0
"1,119",2015,The Final Master,7900000,0,7900000
"1,120",2010,Centurion,7885048,123570,7761478
"1,121",2019,Eiga: Tôken ranbu,7858150,0,7858150
"1,122",2015,Seinto Seiya: Legend of Sanctuary,7851441,0,7851441
"1,123",2018,7 Guardians of the Tomb,7835554,0,7835554
"1,124",2013,Reonningmaen,7818396,0,7818396
"1,125",2016,Pitbull. Nowe porzadki,7802960,0,7802960
"1,126",1991,If Looks Could Kill,7781025,7781025,0
"1,127",2020,Yakusoku no Neverland,7761083,0,7761083
"1,128",2018,Beirut,7760380,5019226,2741154
"1,129",2007,DOA: Dead or Alive,7755686,480314,7275372
"1,130",2017,Yin Bao Zhe,7736408,118384,7618024
"1,131",2007,The Hunting Party,7729552,876671,6852881
"1,132",1990,Blue Steel,7701707,7701707,0
"1,133",1994,Surviving the Game,7690013,7690013,0
"1,134",1984,Ninja III: The Domination,7610785,7610785,0
"1,135",2009,Ong-Bak 2,7583050,102458,7480592
"1,136",2019,Kamen raidâ Reiwa Za Fâsuto Jenerêshon,7529337,0,7529337
"1,137",2008,Tashan,7512447,457380,7055067
"1,138",1981,An Eye for an Eye,7496681,7496681,0
"1,139",2022,Ponniyin Selvan: Part One,7408944,4918000,2490944
"1,140",2007,The Condemned,7371706,7371706,0
"1,141",2018,Simmba,7362331,5102129,2260202
"1,142",2016,Mafiya: Igra na vyzhivanie,7313343,0,7313343
"1,143",1988,Off Limits,7242035,7242035,0
"1,144",2017,Birth of the Dragon,7220490,6901965,318525
"1,145",2017,Mugen no jûnin,7164577,150532,7014045
"1,146",2016,Cuerpo de élite,7145405,0,7145405
"1,147",2021,Kogda padali aisty (Чернобыль),7129817,0,7129817
"1,148",2015,Gekijouban Kamen raidâ Doraibu: Sapuraizu fyûch…,7118376,0,7118376
"1,149",1969,Where Eagles Dare,7100436,7100000,436
"1,150",1978,Force 10 from Navarone,7100000,7100000,0
"1,151",2007,Rescue Dawn,7037886,5490423,1547463
"1,152",2022,Desibel (데시벨),7037457,60653,6976804
"1,153",2008,Arn - Riket vid vägens slut,6998907,0,6998907
"1,154",1985,Stick,6964734,6964734,0
"1,155",1986,Blue City,6947000,6947000,0
"1,156",1989,Dead Bang,6935216,6935216,0
"1,157",1985,Red Sonja,6908640,6905861,2779
"1,158",2007,Redline,6881021,6881021,0
"1,159",1987,Death Wish 4: The Crackdown,6880310,6880310,0
"1,160",2016,Blood Father,6820000,0,6820000
"1,161",2007,Apocalypse Code,6811168,0,6811168
"1,162",2018,Jai Simha,6763950,0,6763950
"1,163",2015,Huai Dan Bi Xu Si,6733311,0,6733311
"1,164",1985,Into the Night,6720160,6720160,0
"1,165",2020,Psy 3: W imie zasad,6717718,0,6717718
"1,166",2021,Yoocheitalja,6648164,0,6648164
"1,167",2016,Bing He Zhui Xiong,6640736,0,6640736
"1,168",1986,Black Moon Rising,6637565,6637565,0
"1,169",1990,Flashback,6476134,6476134,0
"1,170",2018,Race 3,6464357,1690861,4773496
"1,171",2011,Attack the Block,6459183,1024175,5435008
"1,172",1987,Wanted: Dead or Alive,6454953,6454953,0
"1,173",1997,Warriors of Virtue,6448817,6448817,0
"1,174",1995,The Hunted,6420615,6420615,0
"1,175",2021,CopShop,6409313,5213243,1196070
"1,176",2015,Michiel de Ruyter,6398807,0,6398807
"1,177",2016,Kamen raidâ Heisei jenerêshonzu: Dr. Pakkuman t…,6394531,0,6394531
"1,178",2017,Shinjuku Suwan II,6355297,0,6355297
"1,179",1997,Most Wanted,6343015,6343015,0
"1,180",2016,Kizumonogatari: I Tekketsu-hen,6324508,0,6324508
"1,181",2005,A Sound of Thunder,6300451,1900451,4400000
"1,182",2019,Kobiety mafii 2,6276042,0,6276042
"1,183",2018,Illang: The Wolf Brigade,6272692,0,6272692
"1,184",2021,Master Ji Gong,6240000,0,6240000
"1,185",2018,Wo Di Ju Xing,6168544,0,6168544
"1,186",1990,Delta Force 2,6154944,6154944,0
"1,187",1982,The Soldier,6123549,6123549,0
"1,188",2017,Gang Tie Fei Long Zhi Zai Jian Ao Te Man,6120728,0,6120728
"1,189",1997,Kull The Conqueror,6086891,6086891,0
"1,190",2019,High & Low The Worst,6081142,0,6081142
"1,191",1987,Assassination,6075793,6075793,0
"1,192",2001,Megiddo: Omega Code 2,6047691,6047691,0
"1,193",1993,Best of the Best 2,6044652,6044652,0
"1,194",1988,The Unholy,6000000,6000000,0
"1,195",1981,Dragonslayer,6000000,6000000,0
"1,196",1988,Braddock: Missing in Action III,6000000,6000000,0
"1,197",1951,Captain Horatio Hornblower R.N.,6000000,6000000,0
"1,198",1977,Thunder & Lightning,6000000,6000000,0
"1,199",2016,Lo Chiamavano Jeeg Robot,5969047,0,5969047
"1,200",2012,Legendary Amazons,5959716,0,5959716
"1,201",2017,Deok Gaai,5919976,0,5919976
"1,202",1988,The Rescue,5855392,5855392,0
"1,203",2019,Mardaani 2,5854240,0,5854240
"1,204",2017,24 Hours to Live,5840146,0,5840146
"1,205",2019,Dragon Force-Rise of Ultraman,5755641,0,5755641
"1,206",1996,Screamers,5701359,5701359,0
"1,207",2017,Kaabil,5697910,0,5697910
"1,208",2009,Blood: The Last Vampire,5683954,256682,5427272
"1,209",1982,Megaforce,5675599,5675599,0
"1,210",2015,Heneral Luna,5665641,206040,5459601
"1,211",2016,Ledokol,5653689,0,5653689
"1,212",1990,Hardware,5649801,5649801,0
"1,213",1993,Batman: Mask of the Phantasm,5635204,5635204,0
"1,214",1985,Avenging Angel,5622787,5622787,0
"1,215",1984,Streets of Fire,5600000,5600000,0
"1,216",1983,The Star Chamber,5600000,5600000,0
"1,217",1982,Vice Squad,5568880,5568880,0
"1,218",2007,Invisible Target,5520795,0,5520795
"1,219",2007,Aqua Teen Hunger Force Colon Movie Film for The…,5520368,5520368,0
"1,220",2007,Cash,5512027,0,5512027
"1,221",2021,The Ice Road,5511265,0,5511265
"1,222",2008,Boku no kanojo wa saibôgu,5506234,0,5506234
"1,223",2016,Collide,5466698,2280004,3186694
"1,224",2021,Jigoku no Hanazono,5464613,0,5464613
"1,225",1992,Split Second,5430822,5430822,0
"1,226",2017,Raees,5429008,2369469,3059539
"1,227",2009,Black,5424328,0,5424328
"1,228",1987,The Sicilian,5406879,5406879,0
"1,229",2016,One Night Only,5350967,0,5350967
"1,230",2002,Equilibrium,5345869,1190018,4155851
"1,231",2016,Chongtian Huo,5345355,78377,5266978
"1,232",2012,Wu Dang,5340000,0,5340000
"1,233",2015,Spooks: The Greater Good,5328721,0,5328721
"1,234",2011,Ironclad,5297411,0,5297411
"1,235",2007,Ladron que roba a ladron,5273266,4011254,1262012
"1,236",2019,Bharat,5254378,2684911,2569467
"1,237",2007,Sivaji,5246967,0,5246967
"1,238",2014,Il ragazzo invisibile,5216102,0,5216102
"1,239",2021,Mayor Grom: Chumnoy Doktor,5209010,0,5209010
"1,240",2002,Formula 51,5204007,5204007,0
"1,241",2019,Underdog,5165131,0,5165131
"1,242",2023,Yuryeong (유령),5157020,0,5157020
"1,243",2017,Gekijô-ban Kamen Raidâ Eguzeido: Tourû Endingu,5107923,0,5107923
"1,244",1983,Vigilante,5091888,5091888,0
"1,245",1970,Two Mules for Sister Sara,5050000,5050000,0
"1,246",2017,Hei Bai Mi Gong,5029820,0,5029820
"1,247",2022,The Legend of Maula Jatt,5019297,525000,4494297
"1,248",2017,Munna Michael,5002289,64949,4937340
"1,249",1988,Hero and the Terror,5000000,5000000,0
"1,250",1995,Top Dog,4992085,4992085,0
"1,251",2008,Jiang shan mei ren,4991819,0,4991819
"1,252",2019,Balkanskiy rubezh,4941357,0,4941357
"1,253",1996,Solo,4932915,4932915,0
"1,254",2018,Gekijô-ban Kamen Raidâ Birudo: Bî Za Wan,4888000,0,4888000
"1,255",2019,Uri: The Surgical Strike,4876800,4185663,691137
"1,256",1986,Band of the Hand,4865912,4865912,0
"1,257",2011,Force,4763946,0,4763946
"1,258",2016,The Warriors,4754904,0,4754904
"1,259",2015,Northmen — A Viking Saga,4732232,0,4732232
"1,260",2016,Kamen Rider 1 Go,4717643,0,4717643
"1,261",1991,Eve of Destruction,4704884,4704884,0
"1,262",1986,Avenging Force,4679650,4679650,0
"1,263",1991,The Hitman,4654288,4654288,0
"1,264",2016,Buddy Cops,4622802,0,4622802
"1,265",1986,Eliminators,4601256,4601256,0
"1,266",2013,Conspirators,4574135,0,4574135
"1,267",2016,Max Steel,4563080,3818664,744416
"1,268",2017,Gekijouban Mazinger Z,4502612,0,4502612
"1,269",2013,Dong-chang-saeng,4467956,0,4467956
"1,270",2017,Fist & Faith,4433919,0,4433919
"1,271",2016,Sanyang,4422347,0,4422347
"1,272",1991,Run,4409328,4409328,0
"1,273",2017,Hello,4394131,0,4394131
"1,274",1982,Forced Vengeance,4388500,4388500,0
"1,275",1990,Dark Angel,4372561,4372561,0
"1,276",2016,Kabali,4369616,3903095,466521
"1,277",2012,Vettai,4366276,202581,4163695
"1,278",2016,Batman: The Killing Joke,4361038,3775000,586038
"1,279",2022,Lang qun (狼群),4343617,23617,4320000
"1,280",2020,Chi Yan,4340000,0,4340000
"1,281",2009,Manatsu no Orion,4323830,0,4323830
"1,282",2008,Flash Point,4318042,3271,4314771
"1,283",2015,Wild Card,4315789,3200,4312589
"1,284",1981,Thief,4301338,4300000,1338
"1,285",2022,Medieval,4298117,1374325,2923792
"1,286",2021,Girls und Panzer das Finale: Part III,4262049,0,4262049
"1,287",2018,Kona fer í stríð,4230717,847495,3383222
"1,288",1989,Red Scorpion,4192000,4192000,0
"1,289",2008,Gekijô ban poketto monsutâ: Daiyamondo & Pâru -…,4168058,0,4168058
"1,290",2021,Kamen Raidâ Seibâ + Kikai Sentai Zenkaijâ: Supâ…,4153985,0,4153985
"1,291",2010,Qi Xiao Luo Han,4120000,0,4120000
"1,292",1995,Tank Girl,4064333,4064333,0
"1,293",2018,Sketch,4020070,0,4020070
"1,294",2020,Marighella,4003501,3502,3999999
"1,295",1931,Ingagi,4000000,4000000,0
"1,296",1987,American Ninja 2: The Confrontation,4000000,4000000,0
"1,297",2016,Die wilden Kerle 6 - Die Legende lebt,3963295,0,3963295
"1,298",2017,Sleight,3934450,3930990,3460
"1,299",2020,The Enforcer of Justice,3890000,0,3890000
"1,300",2007,Tian tang kou,3887998,0,3887998
"1,301",1984,Flashpoint,3854833,3854833,0
"1,302",2018,Nanatsu no Taizai Movie,3840168,0,3840168
"1,303",2021,Seobok,3825490,0,3825490
"1,304",2017,Free Fire,3793739,1799322,1994417
"1,305",1987,Death Before Dishonor,3776540,3776540,0
"1,306",1996,Barb Wire,3775952,3775952,0
"1,307",1987,The Monster Squad,3769990,3769990,0
"1,308",2020,Malang,3769620,0,3769620
"1,309",2007,Nitro,3768878,3768878,0
"1,310",1984,Exterminator 2,3739406,3739406,0
"1,311",2016,Birkebeinerne,3731296,8905,3722391
"1,312",2020,Ava,3722080,497747,3224333
"1,313",2019,Saaho,3717911,2626284,1091627
"1,314",2006,BloodRayne,3711633,2405420,1306213
"1,315",2012,Cockpit,3692388,0,3692388
"1,316",2007,Tsubaki Sanjûrô,3675205,0,3675205
"1,317",2020,Fate/Grand Order Shinsei Entaku Ryoiki Camelot:…,3658090,0,3658090
"1,318",2008,The Storm Rider,3651400,0,3651400
"1,319",2021,Misyeon paseobeul,3628031,0,3628031
"1,320",2015,Big Game,3620329,24752,3595577
"1,321",2019,Bacurau,3594115,58115,3536000
"1,322",1988,Dead Heat,3588626,3588626,0
"1,323",2008,Gekijoban Kamen Raida Den'o and Kiba Kuraimakku…,3558763,0,3558763
"1,324",1982,The Challenge,3534852,3534852,0
"1,325",2022,Teuksong (특송),3504022,0,3504022
"1,326",1986,The Wraith,3500000,3500000,0
"1,327",2021,Kasouken no Onna Gekijoban (科捜研の女 -劇場版-)…,3450057,0,3450057
"1,328",2013,Tom yum goong 2,3407036,2463,3404573
"1,329",1986,Born American,3401376,3401376,0
"1,330",2016,Shuriken Sentai Ninninja tai Ressha Sentai Tokk…,3355599,0,3355599
"1,331",2013,Oldboy,3343567,2193658,1149909
"1,332",2016,Alibaba Solomons Seal,3330000,0,3330000
"1,333",2016,Girls und Panzer The FILM,3324526,0,3324526
"1,334",2011,13,3317662,0,3317662
"1,335",2016,Warrior’s Gate,3303741,0,3303741
"1,336",2019,Su Ren te Gong,3283238,0,3283238
"1,337",1996,Original Gangstas,3279266,3279266,0
"1,338",2021,Fate Grand Order: The Grand Temple of Time,3268960,0,3268960
"1,339",2005,Supercross,3252550,3102550,150000
"1,340",2018,Monster Strike The Movie: Sora no Kanata,3249907,0,3249907
"1,341",1985,Gymkata,3249442,3249442,0
"1,342",2015,Gekijouban Yowamushi pedaru,3230701,0,3230701
"1,343",2008,Dachimawa Lee,3229037,0,3229037
"1,344",2022,Dilberay Küçük Dev Kadin,3227933,0,3227933
"1,345",2021,Zhen San Guo Wu Shuang,3191623,0,3191623
"1,346",2017,"Gentleman: Sundar, Susheel, Risky",3178269,410055,2768214
"1,347",2018,Over Drive,3161652,0,3161652
"1,348",2019,Panipat,3119830,461863,2657967
"1,349",2022,Limembeo (리멤버),3118646,0,3118646
"1,350",1968,Coogan's Bluff,3110000,3110000,0
"1,351",2017,Rasuto koppu: The Movie,3096923,0,3096923
"1,352",1989,Kinjite,3088086,3088086,0
"1,353",2019,Spasti Leningrad,3068838,0,3068838
"1,354",2015,Anacleto: Agente secreto,3020332,0,3020332
"1,355",1982,Fighting Back,3016496,3016496,0
"1,356",2012,Thaandavam,3006802,213476,2793326
"1,357",1987,Malone,3000000,3000000,0
"1,358",1973,Westworld,3000000,3000000,0
"1,359",1986,Bullies,2995527,2995527,0
"1,360",2015,The Squad,2975825,0,2975825
"1,361",2017,Lieol,2970964,0,2970964
"1,362",2015,Kamen Raidâ × Kamen Raidâ Gôsuto ando Doraibu C…,2952681,0,2952681
"1,363",2022,Ddeugeoun Pi (뜨거운 피),2924979,0,2924979
"1,364",1984,The Warrior and the Sorceress,2886225,2886225,0
"1,365",2019,Ba Zi,2883905,0,2883905
"1,366",2015,Tracers,2880901,2000,2878901
"1,367",2014,Kick,2879840,2472695,407145
"1,368",2016,Swap,2870001,0,2870001
"1,369",1987,Heat,2833142,2793214,39928
"1,370",2019,Geroy (2019),2829544,0,2829544
"1,371",2012,Chakravyuh,2827265,0,2827265
"1,372",2017,Gekijouban Mahouka Koukou no Rettousei: Hoshi o…,2825976,0,2825976
"1,373",2016,Tschiller: Off Duty,2821972,0,2821972
"1,374",1983,Yor: Hunter From the Future,2810199,2810199,0
"1,375",1992,Year of the Comet,2791515,2791515,0
"1,376",2017,Masterpiece,2787298,0,2787298
"1,377",2023,Sisu,2773739,585000,2188739
"1,378",2020,The Comeback Trail,2736770,0,2736770
"1,379",2019,Girls und Panzer das Finale: Part II,2721506,0,2721506
"1,380",2019,Avanpost,2710285,0,2710285
"1,381",2022,Çakallarla Dans 6,2683386,0,2683386
"1,382",2007,Fool N Final,2673450,0,2673450
"1,383",2008,Redbelt,2667084,2344847,322237
"1,384",2013,Commando,2667034,0,2667034
"1,385",2021,gang-reung (강릉),2664647,0,2664647
"1,386",2014,Serbuan maut 2: Berandal,2625803,2625803,0
"1,387",2017,Inhumans,2621654,1521787,1099867
"1,388",2020,Gekijôban Kamen Raidâ Zerowan,2611150,0,2611150
"1,389",2007,Middonaito Îguru,2607116,7116,2600000
"1,390",2019,Jiu Long Bu Bai,2605455,0,2605455
"1,391",2018,Gong Fu Lian Meng,2577213,0,2577213
"1,392",2015,Gatao,2546192,0,2546192
"1,393",2020,Sıfır Bir,2537294,0,2537294
"1,394",2015,Son Mektup,2530705,0,2530705
"1,395",1992,Aces: Iron Eagle III,2517600,2517600,0
"1,396",2016,KanColle: The Movie,2516283,0,2516283
"1,397",1989,Gleaming the Cube,2454590,2454590,0
"1,398",1985,Gojira,2443200,2443200,0
"1,399",2017,Strangers,2430165,0,2430165
"1,400",2006,Renaissance,2401413,70644,2330769
"1,401",1996,Lawnmower Man 2: Beyond Cyberspace,2396302,2396302,0
"1,402",1990,King of New York,2389850,2389850,0
"1,403",2017,Sha Jiu Shen,2350000,0,2350000
"1,404",1990,Blind Fury,2345628,2345628,0
"1,405",2015,Memories of the Sword,2345062,111071,2233991
"1,406",1994,Double Dragon,2341309,2341309,0
"1,407",2015,American Heist,2341218,0,2341218
"1,408",2012,Paan Singh Tomar,2315251,40311,2274940
"1,409",2017,The Village of No Return,2307393,0,2307393
"1,410",2006,Kokoda,2301966,0,2301966
"1,411",2019,Mie Dai Zong Shi,2300000,0,2300000
"1,412",2015,Vedalam,2277999,0,2277999
"1,413",1991,Showdown in Little Tokyo,2275557,2275557,0
"1,414",1986,"No Retreat, No Surrender",2273045,2273045,0
"1,415",2022,Krylya nad Berlinom (1941. Крылья над Берлином)…,2259123,0,2259123
"1,416",2020,Kishiryû Sentai Ryuusoujâ Bui Esu Rupanrenjâ Bu…,2242513,0,2242513
"1,417",2018,"Panku-zamurai, kirarete sôrô",2232159,0,2232159
"1,418",1987,The Squeeze,2228951,2228951,0
"1,419",2006,Don,2223961,2223961,0
"1,420",2007,Hing dai,2213095,0,2213095
"1,421",2017,Mersal,2168812,0,2168812
"1,422",2019,Danger Close: The Battle of Long Tan,2149526,0,2149526
"1,423",2020,Bad Boy,2149168,0,2149168
"1,424",2021,Nebo,2134558,0,2134558
"1,425",2007,Tie saam gok,2129774,0,2129774
"1,426",2018,Mukkabaaz,2116692,0,2116692
"1,427",1983,Who Dares Wins,2108197,2108197,0
"1,428",2002,State Property,2099719,2099719,0
"1,429",2020,The Outpost,2099653,186634,1913019
"1,430",2015,The Last: Naruto the Movie,2085455,483795,1601660
"1,431",2013,Man of Tai Chi,2054941,0,2054941
"1,432",2014,Z Storm,2053330,0,2053330
"1,433",1993,El Mariachi,2041928,2040920,1008
"1,434",1991,Akira,2021239,19585,2001654
"1,435",2012,The Pelayos,2015219,0,2015219
"1,436",2020,Echo Boomers,2003433,0,2003433
"1,437",2015,Last Knights,1975720,0,1975720
"1,438",2018,Magical Girl Lyrical Nanoha: Detonation,1956419,0,1956419
"1,439",2012,Arme Riddere,1953002,806,1952196
"1,440",2015,Singh Is Bliing,1939033,919095,1019938
"1,441",2020,Sooryavanshi,1915877,0,1915877
"1,442",2017,Kurtlar Vadisi: Vatan,1893015,0,1893015
"1,443",2021,Dayı: Bir Adamın Hikâyesi,1892620,0,1892620
"1,444",1997,Masterminds,1890472,1890472,0
"1,445",2010,Chuzhaya,1849944,0,1849944
"1,446",2017,Sojunghan Yeoin,1811452,0,1811452
"1,447",2011,Mo-bi-dik,1775209,0,1775209
"1,448",2012,Department,1765771,0,1765771
"1,449",2007,Teng Nong Khon Maha-Hia,1759123,0,1759123
"1,450",2022,Vikram,1750755,0,1750755
"1,451",2021,Ultimate Code,1740000,0,1740000
"1,452",2015,Bølgen,1734304,177404,1556900
"1,453",2016,I.T.,1718502,0,1718502
"1,454",2016,Mine,1714156,0,1714156
"1,455",1994,Death Wish V: The Face of Death,1711424,1711424,0
"1,456",2015,Mang Long Te Jiong,1708770,0,1708770
"1,457",2020,Vratar galaktiki,1704393,0,1704393
"1,458",1989,Best of the Best,1700000,1700000,0
"1,459",2022,Acharya,1693872,1412000,281872
"1,460",2005,State Property 2,1691706,1691706,0
"1,461",1997,Steel,1686429,1686429,0
"1,462",2013,Combustion,1683711,0,1683711
"1,463",2016,Mohenjo Daro,1680885,1264339,416546
"1,464",2014,Shingeki no kyojin: Guren no yumiya,1679927,0,1679927
"1,465",2015,Black (2015),1671070,0,1671070
"1,466",2017,Zhong Guo Tui Xiao Yuan,1637776,0,1637776
"1,467",2005,Secuestro Express,1629473,302256,1327217
"1,468",2011,The Reunion,1628770,0,1628770
"1,469",2014,Jai Ho,1574865,1187266,387599
"1,470",2021,Qí qíng kuài chē (奇情快车),1570000,0,1570000
"1,471",2023,Haita de actiune,1562418,0,1562418
"1,472",2017,Defenders,1549782,0,1549782
"1,473",2019,Prince of Legend,1549118,0,1549118
"1,474",2016,Laavor et hakir,1547643,1412404,135239
"1,475",2012,Universal Soldier: Day of Reckoning,1545188,5460,1539728
"1,476",2021,Seeti Maar,1544218,0,1544218
"1,477",2018,Rubezh,1537478,0,1537478
"1,478",2017,Renegades,1521672,0,1521672
"1,479",2017,Daddy,1502202,0,1502202
"1,480",2023,Varisu,1496536,0,1496536
"1,481",2015,Chuen lik kau saat,1492099,0,1492099
"1,482",2017,My Pet Dinosaur,1490107,0,1490107
"1,483",2014,Singham Returns,1469185,1226581,242604
"1,484",1986,Sky Bandits,1468500,1468500,0
"1,485",2022,Chōng chū dìqiú,1460000,0,1460000
"1,486",2020,Geom gaek,1455960,0,1455960
"1,487",2006,Kamen Rider Kabuto: God Speed Love,1441305,0,1441305
"1,488",1998,In God's Hands,1431239,1431239,0
"1,489",2018,Jie Ma You Xi,1422563,0,1422563
"1,490",1990,The Last of the Finest,1395694,1395694,0
"1,491",2020,Podolskiye kursanty,1388366,0,1388366
"1,492",1985,Certain Fury,1381091,1381091,0
"1,493",2017,Gekijôban Fairy Tail: Dragon Cry,1378312,519461,858851
"1,494",2018,Revenge,1373476,99197,1274279
"1,495",2016,Dishoom,1364949,812737,552212
"1,496",2018,Deliler,1364179,0,1364179
"1,497",1982,Sorceress,1358792,1358792,0
"1,498",2018,Patser,1357706,0,1357706
"1,499",2015,Game Therapy,1341185,0,1341185
"1,500",2012,Forces spéciales,1335641,10759,1324882
"1,501",2015,Kôkaku Kidôtai,1332311,101203,1231108
"1,502",2004,Warriors of Heaven and Earth,1318382,82382,1236000
"1,503",2020,The Tax Collector,1309971,1044212,265759
"1,504",1986,8 Million Ways to Die,1305114,1305114,0
"1,505",1983,Eddie Macon's Run,1300000,1300000,0
"1,506",2017,Dōbutsu Sentai Jūōjā Tai Ninninjā Mirai kara no…,1293955,0,1293955
"1,507",2007,Eklavya - The Royal Guard,1290212,1290212,0
"1,508",2017,Jungle,1287789,0,1287789
"1,509",2020,Baaghi 3,1285616,721439,564177
"1,510",2022,Diabolik 2,1270173,0,1270173
"1,511",2017,Babumoshai Bandookbaaz,1258122,0,1258122
"1,512",2009,Outlander,1250617,166003,1084614
"1,513",2015,Beyond the Mask,1236094,1236094,0
"1,514",1983,Turkey Shoot,1233657,1233657,0
"1,515",1927,Metropolis,1206834,1206834,0
"1,516",1991,Kickboxer 2: The Road Back,1206817,1206817,0
"1,517",2016,Trespass Against Us,1201442,5711,1195731
"1,518",2013,11.6,1193022,0,1193022
"1,519",2020,Türkler Geliyor: Adaletin Kilici,1184081,0,1184081
"1,520",2020,Sarileru Neekevvaru,1180306,821000,359306
"1,521",2018,Burn Out,1144435,0,1144435
"1,522",2008,Outlaw,1127359,0,1127359
"1,523",2016,Ma Xiaole and His Toys,1120000,0,1120000
"1,524",2019,Placa de Acero,1110372,0,1110372
"1,525",1999,Unconditional Love,1101999,115202,986797
"1,526",2022,Gekijouban Sword Art Online the Movie Progressi…,1095656,607000,488656
"1,527",2012,Road to Ninja: Naruto the Movie,1071136,0,1071136
"1,528",2017,Suo Li,1070000,0,1070000
"1,529",2020,Shadow in the Cloud,1060738,156932,903806
"1,530",2015,Kidô senshi Gandamu: The Origin II - Kanashimi …,1056670,0,1056670
"1,531",2022,Muru,1053706,0,1053706
"1,532",2021,Nordsjøen,1050225,493,1049732
"1,533",2001,Extreme Days,1047553,1047553,0
"1,534",2004,Ghost in the Shell 2: Innocence,1043896,1043896,0
"1,535",2022,Historias para no contar,1025290,0,1025290
"1,536",2016,Marauders,1024158,0,1024158
"1,537",2018,Skif,1020458,0,1020458
"1,538",2017,Beyond Skyline,1012368,0,1012368
"1,539",2017,Bijeonggyujik Teuksuyowon,1008678,0,1008678
"1,540",2003,Cowboy Bebop,1005928,999435,6493
"1,541",2022,Beast,993910,430000,563910
"1,542",2015,Robot Overlords,991329,0,991329
"1,543",2016,Em Nome da Lei,980418,0,980418
"1,544",2020,Thirteen Kill,980000,0,980000
"1,545",2017,Geukjangpan ttobot: robotgundanui seupgyeok,973187,0,973187
"1,546",2021,Omerta 6/12,958440,0,958440
"1,547",2020,Given,955989,0,955989
"1,548",2016,Mahana,947082,0,947082
"1,549",1988,Watchers,940173,940173,0
"1,550",1991,The Taking of Beverly Hills,939277,939277,0
"1,551",2018,211,937961,0,937961
"1,552",2014,Huang feihong zhi yingxiong you meng,935847,0,935847
"1,553",2015,Vice,935485,0,935485
"1,554",2017,Zona Hostil,931357,0,931357
"1,555",2021,Pobaby,920000,0,920000
"1,556",2016,Le convoi,913048,0,913048
"1,557",2019,L'intervention,909816,0,909816
"1,558",1989,American Ninja 3: Blood Hunt,902000,902000,0
"1,559",1986,The Naked Cage,897589,897589,0
"1,560",1983,Stryker,887080,887080,0
"1,561",1990,The Blood of Heroes,882290,882290,0
"1,562",2020,Ma Yong Zhen Zhi Zha Bei Jue,870000,0,870000
"1,563",2022,Tři Tygři ve filmu: Jackpot,869452,0,869452
"1,564",1995,Kôkaku kidôtai,864973,816748,48225
"1,565",2015,Survivor,864171,0,864171
"1,566",2016,Las Aparicio,860502,0,860502
"1,567",2021,Gunpowder Milkshake,859571,0,859571
"1,568",1987,Nowhere to Hide,847468,847468,0
"1,569",2014,Ek Villain,842857,414116,428741
"1,570",2011,Hobo with a Shotgun,834953,703372,131581
"1,571",2015,Code Geass: Boukoku no Akito 3 - Kagayakumono T…,834927,0,834927
"1,572",2018,Dragged Across Concrete,830581,0,830581
"1,573",1985,The Protector,829239,829239,0
"1,574",2018,Braven,826472,0,826472
"1,575",2020,Zui Ke Ai De Ren,810000,0,810000
"1,576",1990,Streets,808730,808730,0
"1,577",1988,Bulletproof,807947,807947,0
"1,578",2018,Can Feda,801012,0,801012
"1,579",1987,The Barbarians,800000,800000,0
"1,580",1984,The River Rat,790254,790254,0
"1,581",2018,Dead in a Week: or Your Money Back,789088,0,789088
"1,582",2015,Gabbar is Back,785594,276429,509165
"1,583",2019,Proxima,777286,0,777286
"1,584",2018,Final Score,776594,0,776594
"1,585",1991,Beastmaster 2: Through the Portal of Time,773490,773490,0
"1,586",2019,Petta,772944,0,772944
"1,587",2021,Nezha,771902,0,771902
"1,588",2022,Wǒ Yào Hé Nǐ Zài Yī Qǐ (我要和你在一起)…,770000,0,770000
"1,589",2021,Gekijôban Sword Art Online Progressive Hoshi na…,754212,0,754212
"1,590",1991,Until the End of the World,752856,752856,0
"1,591",2021,Las leyes de la frontera,749609,0,749609
"1,592",2011,Assassination Games,744012,0,744012
"1,593",1998,Men with Guns,742032,742032,0
"1,594",2019,Bratstvo,739934,0,739934
"1,595",2018,Diablo,735951,0,735951
"1,596",2010,Valhalla Rising,731613,30638,700975
"1,597",2016,Zhong Ji Ying Han,731388,0,731388
"1,598",2018,Slaughterhouse Rulez,730670,4665,726005
"1,599",2000,Taxi 2,729844,729844,0
"1,600",2014,K Missing Kings,725702,0,725702
"1,601",2019,Hai Phuong,721039,594788,126251
"1,602",2020,Vtorzhenie,716503,0,716503
"1,603",2022,HIT: The 2nd Case,713759,600000,113759
"1,604",2020,Darbar,711256,0,711256
"1,605",2003,Fat Pizza,705028,0,705028
"1,606",2018,Miniteukgongdae X,690922,0,690922
"1,607",1996,Bloodsport 2,684351,684351,0
"1,608",2015,Qi Huan Nv Xia,670000,0,670000
"1,609",2016,Mobile Suit Gundam The Origin IV,661883,0,661883
"1,610",2015,Fatih'in Fedaisi Kara Murat,656479,0,656479
"1,611",2011,Sengoku Basra: The Last Party,655018,0,655018
"1,612",2014,In the Blood,650881,0,650881
"1,613",1989,Cage,647032,618178,28854
"1,614",2016,СПАРТА,641359,0,641359
"1,615",2020,Tanhaji: The Unsung Warrior,640761,0,640761
"1,616",2019,Line of Duty,640363,0,640363
"1,617",2017,Zama,635821,200181,435640
"1,618",2022,Duo Ming Huang Jin (夺命黄金),630000,0,630000
"1,619",2022,K.G.F. Chapter 2,629038,0,629038
"1,620",2018,Kôdo giasu: Hangyaku no rurûshu Ep III,620280,0,620280
"1,621",2021,Fan Ji Zhe,620000,0,620000
"1,622",2014,Happy New Year,619761,0,619761
"1,623",2022,Kim Bu Aile,611454,0,611454
"1,624",2020,Haisukūru Furīto,609346,0,609346
"1,625",2016,Showdown in Manila,606238,0,606238
"1,626",2023,Kisi Ka Bhai Kisi Ki Jaan,605288,0,605288
"1,627",2022,Shin Urotoraman (シン・ウルトラマン),603016,601490,1526
"1,628",1986,Knights of the City,601451,601451,0
"1,629",2023,Thunivu,596474,0,596474
"1,630",2022,Vikram Vedha,591618,0,591618
"1,631",2022,deo killeo: jukeodo doineun ai (더 킬러: 죽어도 되는 아이…,591155,134716,456439
"1,632",2006,Achiwa Ssipak,584584,0,584584
"1,633",2022,Odnazhdy v pustyne,583894,0,583894
"1,634",2014,Kochadaiiyaan,583172,583172,0
"1,635",2014,Plastic,575371,0,575371
"1,636",2022,Rise of the Teenage Mutant Ninja Turtles: The M…,570000,0,570000
"1,637",2009,Vengeance,569192,0,569192
"1,638",2015,Phantom,566099,489984,76115
"1,639",2019,Dear Comrade,563850,457000,106850
"1,640",1987,Steel Dawn,562187,562187,0
"1,641",2021,Radhe,559347,0,559347
"1,642",2022,Ek Villain Returns,557426,0,557426
"1,643",2019,Killerman,553406,291477,261929
"1,644",1987,The Time Guardian,548000,548000,0
"1,645",2016,Deliormanli,546823,0,546823
"1,646",2017,Kôkyô shihen Eureka sebun Hai-eboryûshon 1,545940,0,545940
"1,647",2015,Sutoreiyâzu kuronikuru,538798,0,538798
"1,648",2015,Power Rangers The Train Force VS Dino Force THE…,538791,0,538791
"1,649",2022,Sarkaru Vaari Paata,536587,0,536587
"1,650",2017,Weeds on Fire,536012,0,536012
"1,651",1999,Baadshah,535021,535021,0
"1,652",2016,Kungfu Boys,530000,0,530000
"1,653",1979,Cuba,527540,527540,0
"1,654",2021,Mediterráneo,526187,0,526187
"1,655",2021,Pushpa: The Rise Part 1,521375,0,521375
"1,656",2018,Air Strike,516279,0,516279
"1,657",2020,The Big Ugly,515399,514107,1292
"1,658",1985,Code Name: Emerald,515029,515029,0
"1,659",2010,Bitch Slap,514537,17365,497172
"1,660",2019,Wildlings,508681,0,508681
"1,661",1993,Street Knight,507656,507656,0
"1,662",2015,Gekijôban Urutoraman Ginga S: Kessen! Urutora 1…,506125,0,506125
"1,663",2019,Stockholm,503632,0,503632
"1,664",2019,La Source,502610,0,502610
"1,665",2018,A Prayer Before Dawn,499527,14453,485074
"1,666",2022,Last Looks,498069,0,498069
"1,667",1989,Crack House,486722,486722,0
"1,668",2019,Kimetsu no Yaiba: Kyōdai no Kizuna,478555,0,478555
"1,669",2023,Selfiee,478385,335775,142610
"1,670",2014,Open Windows,473486,0,473486
"1,671",2017,"Gekijôban Urutoraman Ôbu: Kizuna no chikara, ok…",473282,0,473282
"1,672",2017,Chuck,470767,322005,148762
"1,673",2018,Lukas,470374,0,470374
"1,674",2003,The Legend of Suriyothai,461581,454255,7326
"1,675",2021,Chang An Fu Yao,460000,0,460000
"1,676",2022,Adanis: Kutsal Kavga,456941,0,456941
"1,677",2017,Sólo se Vive una Vez,456535,0,456535
"1,678",2022,Malazgirt 1071,453622,0,453622
"1,679",1994,American Cyborg: Steel Warrior,447784,447784,0
"1,680",2020,Infamous,446584,429148,17436
"1,681",2015,Bizim Hikaye,444156,0,444156
"1,682",2022,MC Helper BeKINGs,433787,0,433787
"1,683",2017,Bairavaa,431722,0,431722
"1,684",2015,Hâmonî,430568,23248,407320
"1,685",2016,Bungaeman,428219,0,428219
"1,686",2015,Entrando Numa Roubada,426775,0,426775
"1,687",2016,Kaashmora,419497,327929,91568
"1,688",2000,Brat 2 (БРАТ 2),415855,0,415855
"1,689",2020,Force of Nature,415582,0,415582
"1,690",2007,The Death and Life of Bobby Z,414617,0,414617
"1,691",2000,The Boondock Saints,411874,30471,381403
"1,692",2012,Seeking Justice,411746,411746,0
"1,693",1995,3 Ninjas Knuckle Up,407618,407618,0
"1,694",1996,Bottle Rocket,407576,407488,88
"1,695",2020,Rogue,401087,0,401087
"1,696",2017,Once Upon a Time in Venice,399166,0,399166
"1,697",2011,Setup,395949,0,395949
"1,698",2020,Geukjangpan miniteukgongdae: haembeogeogoemuleu…,392485,0,392485
"1,699",2019,Iron Sky: The Coming Race,392166,0,392166
"1,700",1979,The First Great Train Robbery,391942,391942,0
"1,701",2015,Boy 7,391735,0,391735
"1,702",2021,Rise of the Footsoldier: Origins,391336,0,391336
"1,703",2022,Bandit,387246,0,387246
"1,704",2016,Lat ging ba wong fa,386261,0,386261
"1,705",2015,Everly,382652,1800,380852
"1,706",2018,Spiritpact,381071,0,381071
"1,707",2022,Anka,381034,0,381034
"1,708",2016,Derailed,380786,0,380786
"1,709",2019,The Kill Team,372311,0,372311
"1,710",2016,24,370369,0,370369
"1,711",2020,Shi Shen Gui Lai,370000,0,370000
"1,712",2016,Code Geass: Boukoku no Akito Final - Itoshiki M…,369062,0,369062
"1,713",2021,Doctor,364701,220000,144701
"1,714",2016,Persona 3 the Movie: #4 Winter of Rebirth,361950,0,361950
"1,715",1990,American Ninja 4: The Annihilation,358000,358000,0
"1,716",2021,15/07 Safak Vakti,356854,0,356854
"1,717",2017,Bordo Bereliler Suriye,355830,0,355830
"1,718",2021,Occupation: Rainfall,354670,0,354670
"1,719",2021,Marakkar: Lion of the Arabian Sea,351585,0,351585
"1,720",2021,Cosmic Sin,349757,0,349757
"1,721",2022,Gojira X Mekagojira,335000,335000,0
"1,722",2005,De Zaak Alzheimer,332015,332015,0
"1,723",2018,Eureka Seven Hi-Evolution 2,331737,0,331737
"1,724",2018,Ride,328531,0,328531
"1,725",2016,Shivaay,323726,0,323726
"1,726",2019,Ice Breaking,320000,0,320000
"1,727",2020,The Hero Battle,320000,0,320000
"1,728",2023,Dasara,318387,0,318387
"1,729",2022,Bachchhan Paandey,318054,0,318054
"1,730",2017,Vivegam,317401,0,317401
"1,731",2017,6 Days,317072,0,317072
"1,732",2016,AmeriGeddon,316554,316554,0
"1,733",2019,Maharshi,316285,0,316285
"1,734",1999,Hindustan Ki Kasam,310330,310330,0
"1,735",2016,I Am Wrath,309608,0,309608
"1,736",2015,Colt 45,309557,0,309557
"1,737",1998,3 Ninjas: High Noon at Mega Mountain,308082,308082,0
"1,738",2017,Gekijō-ban Kuroshitsuji: Book of the Atlantic,308060,0,308060
"1,739",2022,Heropanti 2,305268,115000,190268
"1,740",1956,Shichinin no samurai,303251,271736,31515
"1,741",2019,Soeurs d'armes,300818,0,300818
"1,742",2017,Security,297932,0,297932
"1,743",2018,Bad Investigate,296646,0,296646
"1,744",1983,Deadly Force,294316,294316,0
"1,745",2016,Shingekijouban Inisharu D: Legend 3 - Mugen,293276,0,293276
"1,746",2014,Innocence,292824,292824,0
"1,747",2018,Parwaaz Hai Junoon,287433,0,287433
"1,748",1987,Cold Steel,285885,285885,0
"1,749",2016,Ghayal Once Again,281755,0,281755
"1,750",2015,El Más Buscado,280340,0,280340
"1,751",2015,Yennai Arindhaal,280323,0,280323
"1,752",2021,Fei zheng shi ai qing,280000,0,280000
"1,753",2019,Hareket Sekiz,274613,0,274613
"1,754",2017,Leidibeogeu,273995,0,273995
"1,755",2019,Reshala: Nulevye,272938,0,272938
"1,756",2023,49,272869,0,272869
"1,757",2004,Dhoom,272497,245756,26741
"1,758",2021,Akhanda,269056,0,269056
"1,759",2022,Bheemla Nayak,266709,0,266709
"1,760",2022,Prithviraj,261994,0,261994
"1,761",2021,Antim: The Final Truth,257000,0,257000
"1,762",2014,Son of a Gun,256003,1411,254592
"1,763",2019,Viswasam,253545,0,253545
"1,764",2017,Singularity,252076,0,252076
"1,765",2022,Liger,250434,0,250434
"1,766",2022,Shamshera,249608,0,249608
"1,767",1996,Ashes of Time,247804,173526,74278
"1,768",2021,Jolt,247538,0,247538
"1,769",2020,La Liga de los 5,245098,0,245098
"1,770",1999,Hello Brother,245034,245034,0
"1,771",2016,Sêrâ-fuku to kikanjû: Sotsugyô,243965,0,243965
"1,772",2003,Steal,240025,220944,19081
"1,773",2021,Escort Vehicle 36,240000,0,240000
"1,774",2020,The Iron Sichuan Army Die Hard,240000,0,240000
"1,775",1983,Young Warriors,238534,238534,0
"1,776",2023,Shehzada,237731,0,237731
"1,777",2015,Tevar,236002,236002,0
"1,778",2021,Vakeel Saab,232092,0,232092
"1,779",2016,My Father Jack,231833,0,231833
"1,780",2023,Bholaa,231697,0,231697
"1,781",2020,Survive the Night,230509,0,230509
"1,782",2018,Infini-T Force: Farewell To Gatcham,230383,0,230383
"1,783",2016,Chao ji bao biao,230000,0,230000
"1,784",1999,One Man's Hero,229311,229311,0
"1,785",2003,Undead,229250,41196,188054
"1,786",2021,Tadap,225852,130934,94918
"1,787",2022,Geukjangpan Wilbenjyeoseu Susanghan Kaempingdae…,222703,0,222703
"1,788",2022,Panama,222669,0,222669
"1,789",1989,Fist Fighter,221163,221163,0
"1,790",2023,Shēn Hǎi Wéi Jī (深海危机),220000,0,220000
"1,791",2016,Dog Eat Dog,219319,0,219319
"1,792",1999,Hote Hote Pyar Ho Gaya,214574,214574,0
"1,793",2016,Force 2,214551,0,214551
"1,794",2008,Hell Ride,213608,213608,0
"1,795",2014,Revenge of the Green Dragons,213164,2500,210664
"1,796",2005,Ek Ajnabee,213143,213143,0
"1,797",2022,Karthikeya 2,212573,0,212573
"1,798",2021,Twist,211734,0,211734
"1,799",1985,Def-Con 4,210904,210904,0
"1,800",2022,Tiān Zhī Shū (天之书),210000,0,210000
"1,801",2022,Major,208091,0,208091
"1,802",2023,Vaathi,206101,0,206101
"1,803",2000,El Circulo Vicioso,205265,205265,0
"1,804",2015,I,203979,0,203979
"1,805",2017,Yeokmo Banlanui Sidae,203900,0,203900
"1,806",2022,Ram Sethu,198723,0,198723
"1,807",2019,Close,198320,0,198320
"1,808",2016,Singam 3,195616,0,195616
"1,809",2015,Hiszpanka,194591,0,194591
"1,810",2012,Starship Troopers: Invasion,192901,0,192901
"1,811",2017,Resident Evil: Vendetta,191408,0,191408
"1,812",2014,Ironclad: Battle for Blood,191154,0,191154
"1,813",1989,For Queen & Country,191051,191051,0
"1,814",2023,Assassin Club,190747,0,190747
"1,815",2018,Galveston,190320,0,190320
"1,816",2021,Feng Kuang De Quan Tou,190000,0,190000
"1,817",2022,Enter the Girl Dragon (龙女孩),190000,0,190000
"1,818",2020,Mumbai Saga,189934,0,189934
"1,819",2021,Warning,188515,0,188515
"1,820",2013,Empire State,187500,0,187500
"1,821",2019,Marjaavaan,187285,0,187285
"1,822",2019,Paradise Beach,186410,0,186410
"1,823",2022,Wyrmwood: Apocalypse,186403,0,186403
"1,824",2020,Kimetsu no Yaiba: Hashira Gou Kaigi—Chouyashiki…,183052,0,183052
"1,825",2016,The Masked Saint,182695,182695,0
"1,826",2018,Reprisal,180437,0,180437
"1,827",2021,"Run, Hide, Fight",179277,0,179277
"1,828",2018,BuyBust,178471,178471,0
"1,829",1988,Seven Hours to Judgment,177820,177820,0
"1,830",2022,Valimai,177201,0,177201
"1,831",2021,Maanaadu,176917,0,176917
"1,832",2021,Red Notice,173638,0,173638
"1,833",2013,"Cinco de Mayo, La Batalla",173472,173472,0
"1,834",2011,Su Qi Er,172348,80096,92252
"1,835",2020,Skylines,170581,0,170581
"1,836",2020,Zhen Jia Mei Hou Wang Zhi Da Sheng Wu Shuang,170000,0,170000
"1,837",2019,Awake,169919,0,169919
"1,838",2022,Prem Geet 3,169372,0,169372
"1,839",2022,Vendetta,169260,0,169260
"1,840",2011,Bellflower,168226,168226,0
"1,841",2022,Cobra,167433,0,167433
"1,842",2017,Kill Switch,163348,0,163348
"1,843",2016,Daegyeol,163046,0,163046
"1,844",2018,Parmanu: The Story of Pokhran,161975,0,161975
"1,845",2022,Kimetsu no Yaiba: Asakusa Hen,161970,0,161970
"1,846",2022,GodFather,160773,0,160773
"1,847",1988,Taffin,159969,159969,0
"1,848",2016,The Call Up,158758,0,158758
"1,849",2018,La 4ª Compañía,158219,0,158219
"1,850",2021,Agent Mambo: True Pac,157807,0,157807
"1,851",2011,Game,157035,132035,25000
"1,852",2017,Kaettekita Dōbutsu Sentai Jūōjā Oinochi Chōdai!…,156259,0,156259
"1,853",2021,Karnan,154809,0,154809
"1,854",2017,Nane ile Limon: Kayıp Zaman Yolcusu,152887,0,152887
"1,855",2020,Tygyn Darkhan,152818,0,152818
"1,856",2018,Turning Mecards W: Secret of Bandain,150950,0,150950
"1,857",2016,Rocky Handsome,149550,0,149550
"1,858",2017,Acts of Vengeance,149313,0,149313
"1,859",2020,The Doorman,148751,0,148751
"1,860",2021,Small World,147973,0,147973
"1,861",2021,SAS: Red Notice,146329,146329,0
"1,862",1986,Thunder Run,145975,145975,0
"1,863",2017,Three Days to Spring,145214,0,145214
"1,864",2023,Viduthalai Part-1,144523,0,144523
"1,865",2017,Pawobaeteul wachika: wachigamyeoneui yeokseub,142728,0,142728
"1,866",2005,Appurushîdo,141928,129135,12793
"1,867",1986,Let's Get Harry,140980,140980,0
"1,868",2016,Ism,138630,134166,4464
"1,869",2005,Matando Cabos,138555,138555,0
"1,870",2021,El Sustituto,137180,0,137180
"1,871",2019,Lucky Day,136439,0,136439
"1,872",2016,Pulimurugan,136353,0,136353
"1,873",2017,First Kill,135979,0,135979
"1,874",2018,Dragon Blade,134540,0,134540
"1,875",2014,Battle of the Damned,134452,0,134452
"1,876",2017,Katamarayudu,134432,0,134432
"1,877",2022,Sardar,133764,0,133764
"1,878",2022,Kaduva,132590,0,132590
"1,879",2016,A Flying Jatt,131962,0,131962
"1,880",2015,Anatomia zla,131081,0,131081
"1,881",2021,Boiseu (보이스 ),130746,0,130746
"1,882",2018,Satyameva Jayate,130489,0,130489
"1,883",2015,Kaaki Sattai,129430,0,129430
"1,884",2015,Yi ge ren de wu lin,129115,129115,0
"1,885",2021,Pitbull,128511,0,128511
"1,886",2022,Blackbird,127092,0,127092
"1,887",2020,Archenemy,122534,121642,892
"1,888",2023,Veera Simha Reddy,121754,0,121754
"1,889",2014,Kundo: min-ran-eui-si-dae,120857,120857,0
"1,890",2014,7 cajas,116390,0,116390
"1,891",2016,Doctor Who: The Power of the Daleks,116162,0,116162
"1,892",2019,Asuran,115812,0,115812
"1,893",2003,Qayamat: City Under Threat,115781,0,115781
"1,894",2022,Efsane Takim: Bilim Kahramanlari,115251,0,115251
"1,895",2022,Green Ghost & The Masters Of The Stone,113687,113687,0
"1,896",2019,Ging chaat goo si/Ging chaat goo si juk jaap,113224,113224,0
"1,897",2014,Young Ones,112814,0,112814
"1,898",2021,The Paper Tigers,112691,112691,0
"1,899",2018,Bordo Bereliler Afrin,112392,0,112392
"1,900",2019,NGK,110955,0,110955
"1,901",2021,No Abduction In The World,110000,0,110000
"1,902",1989,"No Retreat, No Surrender 2",108154,108154,0
"1,903",1984,Slayground,108128,108128,0
"1,904",2015,Maari,107917,0,107917
"1,905",2020,Ik Sandhu Hunda Si,107780,0,107780
"1,906",2015,American Hero,107590,0,107590
"1,907",2015,Wyrmwood,106916,0,106916
"1,908",2018,Gekijôban Shingeki no Kyojin Season 2: Kakusei …,106850,0,106850
"1,909",2014,The Anomaly,105632,0,105632
"1,910",2017,Raag Desh,104431,0,104431
"1,911",2008,Beaufort,102342,102342,0
"1,912",2015,Thani Oruvan,101996,0,101996
"1,913",2012,Mugamoodi,101911,101911,0
"1,914",2018,Kickboxer: Retaliation,101690,4537,97153
"1,915",1989,Race for Glory,100326,100326,0
"1,916",2015,Mo Ka Xing Dong,100000,0,100000
"1,917",1985,Flesh & Blood,100000,100000,0
"1,918",2012,6 Bullets,99861,0,99861
"1,919",2018,Teefa in Trouble,98806,0,98806
"1,920",2022,A Day to Die,98616,0,98616
"1,921",2018,The Kiss Addict,98143,0,98143
"1,922",2022,Etharkkum Thunindhavan,97046,0,97046
"1,923",2016,Wo Shi Ying Xiong,96920,0,96920
"1,924",2019,Sordo,96887,0,96887
"1,925",2005,D.E.B.S.,96793,96793,0
"1,926",2019,Sonchiriya,96056,86765,9291
"1,927",2017,Stratton,95743,0,95743
"1,928",2017,Monsoon Shootout,93721,0,93721
"1,929",2022,Viruman,93534,0,93534
"1,930",2021,Sulthan,93482,0,93482
"1,931",2018,Reign of Judges: Title of Liberty,93224,93224,0
"1,932",2023,Pathu Thala,93040,0,93040
"1,933",2022,Komutan,92297,0,92297
"1,934",2019,The Heart,91344,0,91344
"1,935",2018,Acts of Violence,91202,0,91202
"1,936",2014,Red Sky,91116,0,91116
"1,937",2018,Super Master & Disciple,91014,0,91014
"1,938",2021,Krack,90557,0,90557
"1,939",2016,The Legend Of Ben Hall,89570,0,89570
"1,940",1986,Jackals,89352,89352,0
"1,941",2001,Time and Tide,88868,88868,0
"1,942",2017,Yalghaar,88821,0,88821
"1,943",2018,Dakuaan Da Munda,88712,0,88712
"1,944",2016,Musudan,86953,0,86953
"1,945",2016,Leifeng Man,84321,0,84321
"1,946",2018,Saamy 2,82519,0,82519
"1,947",2015,Baby,82411,0,82411
"1,948",2016,Silk Road Hero: Khan's Arrow,81873,0,81873
"1,949",1999,Lal Baadshah,81873,81873,0
"1,950",2003,Sky Blue,81664,73653,8011
"1,951",1999,Vaastar,81367,81367,0
"1,952",2020,Bi Xue Jin Yi Wei,80000,0,80000
"1,953",2020,No Drugs in the World,80000,0,80000
"1,954",2019,A Score To Settle,79992,0,79992
"1,955",2018,Odiyan,79385,0,79385
"1,956",2017,Solo,79272,0,79272
"1,957",2016,Kickboxer: Vengeance,78794,0,78794
"1,958",2021,Satyameva Jayate 2,77847,0,77847
"1,959",2017,Naam Shabana,77441,0,77441
"1,960",2020,Chick Fight,76774,0,76774
"1,961",2022,An Action Hero,76746,0,76746
"1,962",2019,Sympathie pour le diable,75295,12144,63151
"1,963",2001,Fah talai jone,75234,75234,0
"1,964",2021,The Lady of Heaven,74441,0,74441
"1,965",2022,Rorschach,73876,0,73876
"1,966",2018,The Seven Deadly Sins: Prisoners of the Sky,73439,0,73439
"1,967",2021,Prisoners of the Ghostland,71456,28204,43252
"1,968",2022,Pineun mulboda jinhada (피는 물보다 진하다)…,71418,0,71418
"1,969",2022,Otorvi i vybros (Оторви и выбрось),70772,0,70772
"1,970",2022,Attack: Part 1,70717,0,70717
"1,971",1999,Kohram,70257,70257,0
"1,972",2019,Fist and Furious,70213,0,70213
"1,973",2018,Wastelander,70045,70045,0
"1,974",2022,Aaraattu,69979,0,69979
"1,975",2020,Jinde Meriye,69813,0,69813
"1,976",2022,Black Site,69609,0,69609
"1,977",2003,The Princess Blade,69386,69386,0
"1,978",2023,Ravanasura,69315,0,69315
"1,979",2006,Beowulf & Grendel,68820,68820,0
"1,980",2019,Hero,68672,0,68672
"1,981",2017,The Hunter’s Prayer,68600,0,68600
"1,982",2019,Super Deluxe,68364,0,68364
"1,983",2022,Kimetsu no Yaiba Tsuzumi Yashiki Hen,67548,0,67548
"1,984",2004,Wake of Death,67444,0,67444
"1,985",2022,Code Name Banshee,67396,0,67396
"1,986",2004,Azumi,66342,41803,24539
"1,987",2002,Snipes,66339,66339,0
"1,988",2021,Masha,66309,0,66309
"1,989",2022,Dakuaan Da Munda 2,64895,0,64895
"1,990",2016,Beauty and the Bestie,64754,0,64754
"1,991",2019,Qian Long Ju Ji,64601,0,64601
"1,992",2016,Grotto,64432,0,64432
"1,993",1986,Low Blow,63860,63860,0
"1,994",2023,Kaizoku Sentai: Ten Gokaiger,63791,0,63791
"1,995",2020,Goblin Slayer: Goblin's Crown,63439,0,63439
"1,996",2021,Vanquish,62673,0,62673
"1,997",2011,Gekijouban Trigun: Badlands Rumble,62027,62027,0
"1,998",2018,Tian Xia Di Yi Biao Ju,62007,0,62007
"1,999",2014,Tiger & Bunny the Movie: The Rising,61562,61562,0
"2,000",2019,Welcome to Acapulco,61410,0,61410
